source	transform	target
your walruses who our yak does accept dont sleep.	quest	dont your walruses who our yak does accept sleep?
the raven that my peacocks dont remember doesnt confuse her tyrannosaurus around some quails.	decl	the raven that my peacocks dont remember doesnt confuse her tyrannosaurus around some quails.
her raven who does high_five my tyrannosaurus does read.	quest	does her raven who does high_five my tyrannosaurus read?
your orangutans that your orangutan doesnt comfort do amuse the vultures around some peacock.	quest	do your orangutans that your orangutan doesnt comfort amuse the vultures around some peacock?
some orangutans that dont comfort our walrus dont eat.	quest	dont some orangutans that dont comfort our walrus eat?
her salamander doesnt sleep does sleep.	quest	does her salamander doesnt sleep sleep?
our xylophones that my tyrannosaurus does applaud dont high_five the newt around the orangutans.	decl	our xylophones that my tyrannosaurus does applaud dont high_five the newt around the orangutans.
our salamander that my newts do amuse doesnt read.	decl	our salamander that my newts do amuse doesnt read.
our quail doesnt smile does eat.	decl	our quail doesnt smile does eat.
our newt that your yaks do confuse doesnt amuse some vultures around the orangutans.	decl	our newt that your yaks do confuse doesnt amuse some vultures around the orangutans.
my raven does swim doesnt confuse my quail who doesnt admire my zebra.	decl	my raven does swim doesnt confuse my quail who doesnt admire my zebra.
her quail who doesnt accept some unicorn doesnt accept your tyrannosaurus behind the unicorns.	decl	her quail who doesnt accept some unicorn doesnt accept your tyrannosaurus behind the unicorns.
the ravens who her tyrannosauruses do amuse do entertain your vultures that dont applaud her tyrannosauruses.	quest	do the ravens who her tyrannosauruses do amuse entertain your vultures that dont applaud her tyrannosauruses?
the ravens who my orangutans do remember dont wait.	quest	dont the ravens who my orangutans do remember wait?
some orangutans who our salamanders dont remember do high_five your newt.	quest	do some orangutans who our salamanders dont remember high_five your newt?
your yaks that do wait dont high_five the newts that her unicorn does admire.	quest	dont your yaks that do wait high_five the newts that her unicorn does admire?
the xylophone doesnt eat does applaud our xylophone.	quest	does the xylophone doesnt eat applaud our xylophone?
some tyrannosauruses that do applaud my newt dont amuse your ravens.	decl	some tyrannosauruses that do applaud my newt dont amuse your ravens.
our quail who our tyrannosaurus doesnt amuse doesnt applaud the quails below the orangutans.	quest	doesnt our quail who our tyrannosaurus doesnt amuse applaud the quails below the orangutans?
some xylophones who do accept our salamanders dont eat.	quest	dont some xylophones who do accept our salamanders eat?
some newts who do comfort my orangutans dont eat.	quest	dont some newts who do comfort my orangutans eat?
my salamanders who your ravens dont comfort do comfort some ravens behind our salamanders.	decl	my salamanders who your ravens dont comfort do comfort some ravens behind our salamanders.
our orangutan that some peacocks dont high_five does remember our vultures that dont comfort our xylophones.	quest	does our orangutan that some peacocks dont high_five remember our vultures that dont comfort our xylophones?
the unicorns who your salamanders dont admire dont comfort our salamander below the tyrannosauruses.	quest	dont the unicorns who your salamanders dont admire comfort our salamander below the tyrannosauruses?
some newts that her yaks dont confuse do entertain some salamanders.	decl	some newts that her yaks dont confuse do entertain some salamanders.
your salamander doesnt wait does entertain some walruses around her orangutan.	quest	does your salamander doesnt wait entertain some walruses around her orangutan?
your vultures who do entertain her newt do comfort her walruses that dont swim.	quest	do your vultures who do entertain her newt comfort her walruses that dont swim?
your quails that do wait do accept her newt who does high_five her yak.	quest	do your quails that do wait accept her newt who does high_five her yak?
her newt who some peacock does high_five does giggle.	decl	her newt who some peacock does high_five does giggle.
the unicorns that your peacocks dont entertain dont admire your quail.	decl	the unicorns that your peacocks dont entertain dont admire your quail.
some ravens that our zebras dont amuse do remember her salamanders by our peacocks.	quest	do some ravens that our zebras dont amuse remember her salamanders by our peacocks?
our quail who some tyrannosaurus does accept does accept her zebras who dont giggle.	decl	our quail who some tyrannosaurus does accept does accept her zebras who dont giggle.
your unicorns who your tyrannosaurus does entertain dont move.	quest	dont your unicorns who your tyrannosaurus does entertain move?
my newt that my newt does accept doesnt move.	decl	my newt that my newt does accept doesnt move.
your quail does wait doesnt entertain our orangutans behind my orangutans.	decl	your quail does wait doesnt entertain our orangutans behind my orangutans.
the orangutans who dont admire my quails do accept your raven that some vulture doesnt entertain.	quest	do the orangutans who dont admire my quails accept your raven that some vulture doesnt entertain?
our zebra does read doesnt change.	quest	doesnt our zebra does read change?
our vultures who do swim dont accept our newt who the salamander doesnt amuse.	decl	our vultures who do swim dont accept our newt who the salamander doesnt amuse.
the newts who some zebra does applaud do change.	decl	the newts who some zebra does applaud do change.
some zebra does change does comfort your orangutans above her salamanders.	quest	does some zebra does change comfort your orangutans above her salamanders?
some salamander who my newt does confuse doesnt confuse our raven who some quails dont applaud.	decl	some salamander who my newt does confuse doesnt confuse our raven who some quails dont applaud.
my tyrannosauruses that do applaud our salamanders do high_five your yaks that do entertain our unicorns.	decl	my tyrannosauruses that do applaud our salamanders do high_five your yaks that do entertain our unicorns.
her newts who my peacock does remember do swim.	quest	do her newts who my peacock does remember swim?
her orangutans who do high_five my peacock dont change.	quest	dont her orangutans who do high_five my peacock change?
our raven doesnt swim does swim.	decl	our raven doesnt swim does swim.
my vultures that do confuse the salamander dont read.	decl	my vultures that do confuse the salamander dont read.
her orangutans that dont eat do accept the unicorn upon her xylophone.	quest	do her orangutans that dont eat accept the unicorn upon her xylophone?
my walrus doesnt sleep doesnt swim.	decl	my walrus doesnt sleep doesnt swim.
my unicorn who does comfort my raven doesnt admire my quails behind my peacocks.	quest	doesnt my unicorn who does comfort my raven admire my quails behind my peacocks?
my newt who doesnt high_five her tyrannosauruses doesnt giggle.	decl	my newt who doesnt high_five her tyrannosauruses doesnt giggle.
our xylophones who do accept the xylophone do wait.	decl	our xylophones who do accept the xylophone do wait.
some quail who our newt doesnt high_five doesnt remember some raven behind my newt.	decl	some quail who our newt doesnt high_five doesnt remember some raven behind my newt.
your vulture that our orangutans dont entertain doesnt high_five her quail upon your zebras.	quest	doesnt your vulture that our orangutans dont entertain high_five her quail upon your zebras?
my raven does eat does admire some newt that does remember the salamander.	decl	my raven does eat does admire some newt that does remember the salamander.
my tyrannosaurus that your vultures do confuse does amuse your yak above the peacocks.	quest	does my tyrannosaurus that your vultures do confuse amuse your yak above the peacocks?
some yaks that dont sleep dont read.	quest	dont some yaks that dont sleep read?
some salamanders that do sleep do confuse some newts around the quail.	quest	do some salamanders that do sleep confuse some newts around the quail?
the newt who her peacock doesnt comfort doesnt amuse my tyrannosaurus doesnt smile.	quest	doesnt the newt who her peacock doesnt comfort amuse my tyrannosaurus doesnt smile?
some newt who our tyrannosauruses do entertain doesnt amuse the newts below the zebra.	quest	doesnt some newt who our tyrannosauruses do entertain amuse the newts below the zebra?
some vultures who her salamander doesnt entertain do entertain your quail.	decl	some vultures who her salamander doesnt entertain do entertain your quail.
her unicorn doesnt sleep does sleep.	decl	her unicorn doesnt sleep does sleep.
your quail who doesnt entertain my xylophones does eat.	quest	does your quail who doesnt entertain my xylophones eat?
our peacock who our ravens dont amuse doesnt move.	quest	doesnt our peacock who our ravens dont amuse move?
my walrus who does applaud my xylophone does smile.	quest	does my walrus who does applaud my xylophone smile?
some raven that does entertain the peacocks does admire some unicorns who some quail does comfort.	quest	does some raven that does entertain the peacocks admire some unicorns who some quail does comfort?
some yaks that do giggle dont eat.	decl	some yaks that do giggle dont eat.
your tyrannosaurus does read doesnt amuse some zebras.	quest	doesnt your tyrannosaurus does read amuse some zebras?
her peacock that your peacock doesnt entertain doesnt swim.	quest	doesnt her peacock that your peacock doesnt entertain swim?
our walrus that doesnt remember my peacocks doesnt move.	decl	our walrus that doesnt remember my peacocks doesnt move.
your quails who my vulture doesnt admire do confuse your orangutan that the tyrannosaurus doesnt applaud.	quest	do your quails who my vulture doesnt admire confuse your orangutan that the tyrannosaurus doesnt applaud?
our orangutans that do admire our peacock dont eat.	decl	our orangutans that do admire our peacock dont eat.
my salamanders who some yak does remember do accept her unicorns.	quest	do my salamanders who some yak does remember accept her unicorns?
my orangutans who dont comfort my xylophones do move.	quest	do my orangutans who dont comfort my xylophones move?
our walruses who our quails dont amuse dont accept the newts.	quest	dont our walruses who our quails dont amuse accept the newts?
our orangutans that do remember the ravens dont read.	quest	dont our orangutans that do remember the ravens read?
your xylophones who dont sleep dont amuse the walrus upon my vultures.	quest	dont your xylophones who dont sleep amuse the walrus upon my vultures?
our yak who your salamanders do accept doesnt wait.	decl	our yak who your salamanders do accept doesnt wait.
our quail doesnt sleep doesnt change.	quest	doesnt our quail doesnt sleep change?
my zebra doesnt swim doesnt applaud our zebra below your vulture.	quest	doesnt my zebra doesnt swim applaud our zebra below your vulture?
some unicorn that does confuse some salamanders doesnt sleep.	quest	doesnt some unicorn that does confuse some salamanders sleep?
her vultures who some peacocks do admire dont wait.	decl	her vultures who some peacocks do admire dont wait.
her walruses who the peacock does accept dont high_five some peacocks below our tyrannosauruses.	decl	her walruses who the peacock does accept dont high_five some peacocks below our tyrannosauruses.
my xylophone who doesnt applaud our peacock does swim.	quest	does my xylophone who doesnt applaud our peacock swim?
some tyrannosaurus that her zebras dont applaud does confuse some salamanders.	quest	does some tyrannosaurus that her zebras dont applaud confuse some salamanders?
her orangutan who does comfort the quail does admire your yak who our newt doesnt comfort.	decl	her orangutan who does comfort the quail does admire your yak who our newt doesnt comfort.
my zebra who does accept her vultures doesnt comfort your orangutans.	decl	my zebra who does accept her vultures doesnt comfort your orangutans.
her orangutan that some zebras dont remember doesnt comfort her peacock above your ravens.	decl	her orangutan that some zebras dont remember doesnt comfort her peacock above your ravens.
some unicorn who doesnt accept the tyrannosaurus doesnt applaud your quail doesnt sleep.	quest	doesnt some unicorn who doesnt accept the tyrannosaurus applaud your quail doesnt sleep?
her xylophone who my yaks dont applaud does accept my orangutan.	quest	does her xylophone who my yaks dont applaud accept my orangutan?
our orangutans that dont amuse the newt do entertain my vultures.	decl	our orangutans that dont amuse the newt do entertain my vultures.
your peacock who her xylophone does comfort doesnt read.	decl	your peacock who her xylophone does comfort doesnt read.
some salamanders that do amuse the peacock dont giggle.	decl	some salamanders that do amuse the peacock dont giggle.
our quail who her salamanders do admire doesnt swim.	decl	our quail who her salamanders do admire doesnt swim.
your orangutans who dont entertain her quail do comfort the unicorn by our unicorns.	quest	do your orangutans who dont entertain her quail comfort the unicorn by our unicorns?
her zebra that does comfort some vultures does swim.	decl	her zebra that does comfort some vultures does swim.
my tyrannosauruses that do confuse the quails do entertain the newt.	quest	do my tyrannosauruses that do confuse the quails entertain the newt?
some salamanders who her peacocks do applaud do move.	decl	some salamanders who her peacocks do applaud do move.
the unicorns that the quail doesnt applaud dont comfort the peacocks that dont comfort some quail.	quest	dont the unicorns that the quail doesnt applaud comfort the peacocks that dont comfort some quail?
our xylophone that doesnt remember her walrus does remember some vultures.	decl	our xylophone that doesnt remember her walrus does remember some vultures.
my ravens who my salamanders do confuse do giggle.	quest	do my ravens who my salamanders do confuse giggle?
the raven that does applaud our quail doesnt accept her newts below my peacocks.	quest	doesnt the raven that does applaud our quail accept her newts below my peacocks?
the newts that my vultures dont remember do comfort your peacocks who her ravens do admire.	decl	the newts that my vultures dont remember do comfort your peacocks who her ravens do admire.
my salamander that your quail doesnt admire doesnt giggle.	decl	my salamander that your quail doesnt admire doesnt giggle.
some orangutan does read does read.	decl	some orangutan does read does read.
our yak doesnt read does amuse some unicorns.	quest	does our yak doesnt read amuse some unicorns?
some tyrannosaurus doesnt swim does amuse the orangutans.	decl	some tyrannosaurus doesnt swim does amuse the orangutans.
some peacock who your newts do entertain does comfort my ravens who do remember our vulture.	quest	does some peacock who your newts do entertain comfort my ravens who do remember our vulture?
our tyrannosaurus doesnt change doesnt admire our newt by the yak.	quest	doesnt our tyrannosaurus doesnt change admire our newt by the yak?
my peacock who her quail does high_five doesnt comfort my yaks who my peacocks do remember.	decl	my peacock who her quail does high_five doesnt comfort my yaks who my peacocks do remember.
the newts who do smile do high_five our unicorns.	quest	do the newts who do smile high_five our unicorns?
your salamander who the newts do entertain doesnt sleep.	quest	doesnt your salamander who the newts do entertain sleep?
the peacock doesnt change does smile.	quest	does the peacock doesnt change smile?
your zebras who dont amuse our yak do giggle.	decl	your zebras who dont amuse our yak do giggle.
her orangutan doesnt swim doesnt change.	quest	doesnt her orangutan doesnt swim change?
our yak who does remember some tyrannosaurus does remember the orangutans who do accept the peacocks.	decl	our yak who does remember some tyrannosaurus does remember the orangutans who do accept the peacocks.
my orangutans that your orangutans do high_five dont admire some newts who do amuse my xylophones.	quest	dont my orangutans that your orangutans do high_five admire some newts who do amuse my xylophones?
the tyrannosauruses who do accept some tyrannosaurus do comfort some raven.	decl	the tyrannosauruses who do accept some tyrannosaurus do comfort some raven.
our walruses who the peacock does accept dont high_five my tyrannosauruses by your newts.	decl	our walruses who the peacock does accept dont high_five my tyrannosauruses by your newts.
your orangutans that my vulture does accept dont eat.	decl	your orangutans that my vulture does accept dont eat.
my salamanders that dont smile do sleep.	quest	do my salamanders that dont smile sleep?
her walruses that dont amuse my vultures do comfort some tyrannosaurus behind our tyrannosaurus.	decl	her walruses that dont amuse my vultures do comfort some tyrannosaurus behind our tyrannosaurus.
the peacocks who do accept her tyrannosauruses dont swim.	quest	dont the peacocks who do accept her tyrannosauruses swim?
my raven who my quails do amuse doesnt comfort our salamanders.	quest	doesnt my raven who my quails do amuse comfort our salamanders?
her yaks who do move dont comfort some peacocks.	decl	her yaks who do move dont comfort some peacocks.
her yak that doesnt admire my orangutans does read.	decl	her yak that doesnt admire my orangutans does read.
my zebras who my newt doesnt applaud dont confuse your xylophones.	decl	my zebras who my newt doesnt applaud dont confuse your xylophones.
the salamanders that your salamanders dont confuse dont applaud your xylophone below my orangutan.	decl	the salamanders that your salamanders dont confuse dont applaud your xylophone below my orangutan.
our peacocks who dont eat dont sleep.	quest	dont our peacocks who dont eat sleep?
our quails who our quail doesnt remember do wait.	decl	our quails who our quail doesnt remember do wait.
some quail doesnt giggle does amuse some orangutan upon the unicorns.	decl	some quail doesnt giggle does amuse some orangutan upon the unicorns.
some newt who doesnt accept her yak doesnt comfort some peacock.	quest	doesnt some newt who doesnt accept her yak comfort some peacock?
your zebras who our unicorn doesnt confuse dont accept your tyrannosaurus.	decl	your zebras who our unicorn doesnt confuse dont accept your tyrannosaurus.
my walruses who dont remember my newt dont giggle.	quest	dont my walruses who dont remember my newt giggle?
the newt doesnt wait doesnt admire my tyrannosauruses near our newts.	quest	doesnt the newt doesnt wait admire my tyrannosauruses near our newts?
our tyrannosaurus doesnt swim does accept our peacock who your newts dont admire.	quest	does our tyrannosaurus doesnt swim accept our peacock who your newts dont admire?
her tyrannosaurus that the salamander does admire doesnt smile.	decl	her tyrannosaurus that the salamander does admire doesnt smile.
some vulture that does accept some tyrannosaurus does giggle.	quest	does some vulture that does accept some tyrannosaurus giggle?
some tyrannosauruses that her zebras dont high_five dont remember her zebra upon some raven.	quest	dont some tyrannosauruses that her zebras dont high_five remember her zebra upon some raven?
some quails that her vultures dont entertain do remember the salamanders above her peacocks.	quest	do some quails that her vultures dont entertain remember the salamanders above her peacocks?
our orangutans who do comfort the yak dont wait.	quest	dont our orangutans who do comfort the yak wait?
my zebra that our raven does high_five does comfort our unicorns that my walrus does admire.	decl	my zebra that our raven does high_five does comfort our unicorns that my walrus does admire.
her salamander that doesnt comfort my unicorn doesnt accept the yaks.	quest	doesnt her salamander that doesnt comfort my unicorn accept the yaks?
your quails who the salamander doesnt accept dont change.	decl	your quails who the salamander doesnt accept dont change.
our zebra does smile does high_five the peacock.	quest	does our zebra does smile high_five the peacock?
your salamanders who my orangutan does high_five dont smile.	quest	dont your salamanders who my orangutan does high_five smile?
our walruses who our tyrannosaurus does remember do admire our zebras who her salamanders dont remember.	decl	our walruses who our tyrannosaurus does remember do admire our zebras who her salamanders dont remember.
the salamander that her raven does high_five does applaud her unicorns with our unicorns.	decl	the salamander that her raven does high_five does applaud her unicorns with our unicorns.
the ravens who dont entertain her xylophone do high_five my walruses that some ravens do confuse.	quest	do the ravens who dont entertain her xylophone high_five my walruses that some ravens do confuse?
her salamander does sleep does confuse my tyrannosauruses.	quest	does her salamander does sleep confuse my tyrannosauruses?
our xylophones who do admire some tyrannosaurus do applaud our vulture.	decl	our xylophones who do admire some tyrannosaurus do applaud our vulture.
her quail who my vultures do applaud doesnt eat.	decl	her quail who my vultures do applaud doesnt eat.
some peacocks who some yaks do amuse dont comfort the salamanders that do eat.	quest	dont some peacocks who some yaks do amuse comfort the salamanders that do eat?
my salamander does sleep does smile.	decl	my salamander does sleep does smile.
my newt that does accept our quail doesnt high_five her orangutans who do confuse the newt.	decl	my newt that does accept our quail doesnt high_five her orangutans who do confuse the newt.
her vultures that dont high_five your vulture dont swim.	decl	her vultures that dont high_five your vulture dont swim.
our quails that do admire the newts do sleep.	quest	do our quails that do admire the newts sleep?
my quail that our salamanders do remember doesnt giggle.	quest	doesnt my quail that our salamanders do remember giggle?
her peacock doesnt giggle doesnt swim.	quest	doesnt her peacock doesnt giggle swim?
our quail that the salamander does admire doesnt giggle.	quest	doesnt our quail that the salamander does admire giggle?
some orangutan does smile doesnt confuse our salamander.	quest	doesnt some orangutan does smile confuse our salamander?
her orangutans that do confuse some yak do remember my peacock who some newts dont remember.	quest	do her orangutans that do confuse some yak remember my peacock who some newts dont remember?
our salamanders that your salamander doesnt remember do comfort your orangutans who dont move.	quest	do our salamanders that your salamander doesnt remember comfort your orangutans who dont move?
your tyrannosaurus that does admire some raven doesnt admire your newt upon your salamander.	decl	your tyrannosaurus that does admire some raven doesnt admire your newt upon your salamander.
the unicorns who your newts dont high_five dont high_five my salamander upon my salamander.	quest	dont the unicorns who your newts dont high_five high_five my salamander upon my salamander?
the zebras who our peacock doesnt amuse do confuse the newts.	decl	the zebras who our peacock doesnt amuse do confuse the newts.
your raven does smile doesnt amuse the quail does read.	decl	your raven does smile doesnt amuse the quail does read.
my raven that does comfort my raven doesnt admire my ravens.	quest	doesnt my raven that does comfort my raven admire my ravens?
your quails that do high_five her raven dont entertain the tyrannosaurus that your newt doesnt applaud.	quest	dont your quails that do high_five her raven entertain the tyrannosaurus that your newt doesnt applaud?
our peacocks who some zebras do admire dont amuse my quail.	decl	our peacocks who some zebras do admire dont amuse my quail.
our walruses who my ravens dont applaud do read.	quest	do our walruses who my ravens dont applaud read?
some peacock who doesnt admire her vulture doesnt move.	quest	doesnt some peacock who doesnt admire her vulture move?
my quail that doesnt amuse some salamander does sleep.	decl	my quail that doesnt amuse some salamander does sleep.
her xylophone that your quails do comfort doesnt read.	quest	doesnt her xylophone that your quails do comfort read?
my tyrannosaurus that doesnt comfort our salamanders doesnt move.	decl	my tyrannosaurus that doesnt comfort our salamanders doesnt move.
our walruses who do remember our salamanders dont eat.	quest	dont our walruses who do remember our salamanders eat?
the tyrannosaurus does eat doesnt change.	decl	the tyrannosaurus does eat doesnt change.
the xylophone that my tyrannosauruses do amuse does entertain her xylophones.	quest	does the xylophone that my tyrannosauruses do amuse entertain her xylophones?
your raven that our zebra doesnt admire does move.	quest	does your raven that our zebra doesnt admire move?
our quail who doesnt high_five our raven doesnt move.	quest	doesnt our quail who doesnt high_five our raven move?
her vultures that do accept our peacocks dont admire her orangutans who dont amuse the xylophone.	decl	her vultures that do accept our peacocks dont admire her orangutans who dont amuse the xylophone.
some quails who dont accept her raven do giggle.	quest	do some quails who dont accept her raven giggle?
some tyrannosauruses that our tyrannosauruses do admire do smile.	quest	do some tyrannosauruses that our tyrannosauruses do admire smile?
her peacock doesnt giggle doesnt sleep.	quest	doesnt her peacock doesnt giggle sleep?
some zebra who your raven doesnt high_five does accept our salamander.	decl	some zebra who your raven doesnt high_five does accept our salamander.
the salamander does swim does sleep.	decl	the salamander does swim does sleep.
some yak doesnt smile does remember some quails.	quest	does some yak doesnt smile remember some quails?
the walrus that doesnt comfort her quails does confuse some peacocks around our quail.	quest	does the walrus that doesnt comfort her quails confuse some peacocks around our quail?
her quail who the peacock does comfort does comfort your quails.	decl	her quail who the peacock does comfort does comfort your quails.
the salamander that doesnt applaud our orangutans doesnt wait.	decl	the salamander that doesnt applaud our orangutans doesnt wait.
my peacocks that dont entertain our zebra dont accept some raven.	quest	dont my peacocks that dont entertain our zebra accept some raven?
the yak doesnt eat doesnt entertain her unicorns.	quest	doesnt the yak doesnt eat entertain her unicorns?
her zebra that my quail does comfort doesnt change.	quest	doesnt her zebra that my quail does comfort change?
her ravens who some walruses dont amuse dont giggle.	quest	dont her ravens who some walruses dont amuse giggle?
the vultures that dont accept your salamanders dont change.	decl	the vultures that dont accept your salamanders dont change.
my ravens that her orangutan does accept dont accept the salamander that does comfort some xylophones.	quest	dont my ravens that her orangutan does accept accept the salamander that does comfort some xylophones?
her tyrannosaurus who the orangutan does admire doesnt change.	quest	doesnt her tyrannosaurus who the orangutan does admire change?
her quail that does high_five my salamanders does swim.	decl	her quail that does high_five my salamanders does swim.
our zebras that do change dont wait.	decl	our zebras that do change dont wait.
her peacocks that your quails dont comfort do change.	decl	her peacocks that your quails dont comfort do change.
my ravens who my unicorn doesnt remember dont entertain your vultures who dont amuse your ravens.	decl	my ravens who my unicorn doesnt remember dont entertain your vultures who dont amuse your ravens.
her orangutan does swim does confuse our peacocks.	quest	does her orangutan does swim confuse our peacocks?
your xylophone does change doesnt move.	decl	your xylophone does change doesnt move.
her tyrannosauruses that some salamander doesnt remember do admire my yaks.	decl	her tyrannosauruses that some salamander doesnt remember do admire my yaks.
some vultures who dont swim dont confuse her ravens.	quest	dont some vultures who dont swim confuse her ravens?
her salamanders who your peacock doesnt amuse do eat.	decl	her salamanders who your peacock doesnt amuse do eat.
our salamanders who the orangutans do amuse dont accept your orangutans.	quest	dont our salamanders who the orangutans do amuse accept your orangutans?
our yaks that your salamanders dont accept dont comfort my ravens.	quest	dont our yaks that your salamanders dont accept comfort my ravens?
the walruses that dont smile dont accept the salamander.	decl	the walruses that dont smile dont accept the salamander.
my peacocks that dont confuse her orangutans dont sleep.	quest	dont my peacocks that dont confuse her orangutans sleep?
my walruses that our xylophones dont entertain do read.	decl	my walruses that our xylophones dont entertain do read.
my zebra who some vultures dont comfort doesnt giggle.	decl	my zebra who some vultures dont comfort doesnt giggle.
our quails who dont giggle do confuse my tyrannosaurus by her raven.	decl	our quails who dont giggle do confuse my tyrannosaurus by her raven.
our salamanders that dont confuse some unicorns dont eat.	quest	dont our salamanders that dont confuse some unicorns eat?
my peacocks that do giggle do high_five your salamander.	quest	do my peacocks that do giggle high_five your salamander?
your unicorn who my salamanders do applaud does comfort the ravens that the xylophone does amuse.	quest	does your unicorn who my salamanders do applaud comfort the ravens that the xylophone does amuse?
her walruses that the vultures dont admire do eat.	decl	her walruses that the vultures dont admire do eat.
your vulture does sleep doesnt remember my peacock that does admire her newts.	decl	your vulture does sleep doesnt remember my peacock that does admire her newts.
your salamanders who dont confuse my quails do admire the peacock that your peacock does comfort.	quest	do your salamanders who dont confuse my quails admire the peacock that your peacock does comfort?
my newts that our raven does applaud do high_five some vultures around our yaks.	decl	my newts that our raven does applaud do high_five some vultures around our yaks.
our salamanders that my unicorns dont applaud do swim.	decl	our salamanders that my unicorns dont applaud do swim.
your yaks who do remember her unicorns dont comfort my yaks.	quest	dont your yaks who do remember her unicorns comfort my yaks?
our vultures who dont swim dont accept the tyrannosauruses.	quest	dont our vultures who dont swim accept the tyrannosauruses?
your salamanders who my quail doesnt comfort do smile.	quest	do your salamanders who my quail doesnt comfort smile?
the xylophone who her walrus doesnt applaud doesnt read.	decl	the xylophone who her walrus doesnt applaud doesnt read.
my raven who our orangutans dont confuse doesnt admire your walrus above my newt.	quest	doesnt my raven who our orangutans dont confuse admire your walrus above my newt?
her quails who dont admire her yak do admire some newt.	decl	her quails who dont admire her yak do admire some newt.
the tyrannosaurus does sleep doesnt eat.	decl	the tyrannosaurus does sleep doesnt eat.
our peacocks that do swim dont swim.	quest	dont our peacocks that do swim swim?
her quail that our newts do amuse doesnt move.	quest	doesnt her quail that our newts do amuse move?
your unicorn who your salamander doesnt applaud doesnt confuse some vulture near the peacock.	quest	doesnt your unicorn who your salamander doesnt applaud confuse some vulture near the peacock?
some tyrannosauruses who do giggle dont swim.	quest	dont some tyrannosauruses who do giggle swim?
the peacock that doesnt high_five some vultures doesnt high_five some xylophones who do admire our raven.	decl	the peacock that doesnt high_five some vultures doesnt high_five some xylophones who do admire our raven.
her vultures that dont change dont smile.	quest	dont her vultures that dont change smile?
the walrus doesnt move does move.	decl	the walrus doesnt move does move.
her orangutans who dont swim do swim.	quest	do her orangutans who dont swim swim?
your xylophones who do admire her vulture dont confuse your vulture.	decl	your xylophones who do admire her vulture dont confuse your vulture.
our peacock that doesnt confuse my ravens doesnt accept the xylophones upon the newts.	decl	our peacock that doesnt confuse my ravens doesnt accept the xylophones upon the newts.
the newt who her quails dont remember does admire my tyrannosaurus.	decl	the newt who her quails dont remember does admire my tyrannosaurus.
her walruses who dont high_five your ravens do entertain her unicorns with our unicorn.	quest	do her walruses who dont high_five your ravens entertain her unicorns with our unicorn?
some yaks who dont wait do comfort the orangutan who the yaks dont applaud.	quest	do some yaks who dont wait comfort the orangutan who the yaks dont applaud?
some tyrannosaurus that doesnt accept our peacock does wait.	quest	does some tyrannosaurus that doesnt accept our peacock wait?
the newt that doesnt accept my peacocks does swim.	decl	the newt that doesnt accept my peacocks does swim.
our salamanders that do accept your salamanders do move.	decl	our salamanders that do accept your salamanders do move.
my walrus who some newts dont confuse doesnt giggle.	quest	doesnt my walrus who some newts dont confuse giggle?
our raven doesnt sleep does giggle.	decl	our raven doesnt sleep does giggle.
the orangutan that doesnt admire her vulture doesnt applaud your peacocks around our orangutan.	quest	doesnt the orangutan that doesnt admire her vulture applaud your peacocks around our orangutan?
your yaks who dont swim dont amuse some quail.	quest	dont your yaks who dont swim amuse some quail?
my zebras that do remember the vultures dont read.	quest	dont my zebras that do remember the vultures read?
the unicorns who dont eat do swim.	decl	the unicorns who dont eat do swim.
my orangutans that dont applaud my ravens dont comfort the newts above the raven.	decl	my orangutans that dont applaud my ravens dont comfort the newts above the raven.
our xylophones who do wait do smile.	decl	our xylophones who do wait do smile.
my quail that doesnt comfort some quails does move.	decl	my quail that doesnt comfort some quails does move.
our tyrannosaurus that does accept your walruses doesnt swim.	quest	doesnt our tyrannosaurus that does accept your walruses swim?
her salamanders who dont comfort some walruses dont eat.	decl	her salamanders who dont comfort some walruses dont eat.
my raven does read does remember some peacock.	quest	does my raven does read remember some peacock?
our newt who her salamander does accept does accept your salamander around our orangutan.	quest	does our newt who her salamander does accept accept your salamander around our orangutan?
my orangutans who my orangutans do high_five do confuse her newts near your salamander.	quest	do my orangutans who my orangutans do high_five confuse her newts near your salamander?
the zebra doesnt eat doesnt move.	decl	the zebra doesnt eat doesnt move.
our unicorn does swim does move.	quest	does our unicorn does swim move?
my vulture doesnt move does accept your tyrannosaurus with the tyrannosaurus.	quest	does my vulture doesnt move accept your tyrannosaurus with the tyrannosaurus?
my unicorn that some ravens dont applaud does accept your unicorns.	decl	my unicorn that some ravens dont applaud does accept your unicorns.
your peacocks that your newts do amuse do eat.	decl	your peacocks that your newts do amuse do eat.
my newt that our raven does entertain doesnt applaud my salamander upon my xylophones.	decl	my newt that our raven does entertain doesnt applaud my salamander upon my xylophones.
your salamanders that our vulture doesnt high_five dont entertain the peacock.	quest	dont your salamanders that our vulture doesnt high_five entertain the peacock?
her quail that my orangutans dont accept does confuse the newt.	decl	her quail that my orangutans dont accept does confuse the newt.
the quails who some orangutans dont remember dont sleep.	decl	the quails who some orangutans dont remember dont sleep.
the orangutan that doesnt admire your walrus does change.	decl	the orangutan that doesnt admire your walrus does change.
the yaks who some salamanders do applaud do applaud some unicorns above her orangutans.	quest	do the yaks who some salamanders do applaud applaud some unicorns above her orangutans?
your raven doesnt wait doesnt wait.	quest	doesnt your raven doesnt wait wait?
her tyrannosaurus does eat doesnt read.	quest	doesnt her tyrannosaurus does eat read?
her vultures that her tyrannosaurus doesnt comfort dont read.	decl	her vultures that her tyrannosaurus doesnt comfort dont read.
our walrus who does applaud her walrus does read.	decl	our walrus who does applaud her walrus does read.
your newt who does applaud our raven doesnt admire some vultures above our peacock.	decl	your newt who does applaud our raven doesnt admire some vultures above our peacock.
her ravens that dont swim do smile.	decl	her ravens that dont swim do smile.
the ravens who her raven doesnt admire do wait.	quest	do the ravens who her raven doesnt admire wait?
my quails that your yak doesnt confuse do confuse your newt.	decl	my quails that your yak doesnt confuse do confuse your newt.
my tyrannosaurus that does amuse the vultures doesnt wait.	quest	doesnt my tyrannosaurus that does amuse the vultures wait?
some zebra who her newts dont admire doesnt high_five her newts.	quest	doesnt some zebra who her newts dont admire high_five her newts?
my quails that her newt does admire dont wait.	decl	my quails that her newt does admire dont wait.
her orangutan that my peacock doesnt admire doesnt giggle.	quest	doesnt her orangutan that my peacock doesnt admire giggle?
some salamanders that some xylophone does comfort do entertain my vulture does eat.	decl	some salamanders that some xylophone does comfort do entertain my vulture does eat.
your orangutan that our xylophones do amuse doesnt accept my walruses that dont eat.	decl	your orangutan that our xylophones do amuse doesnt accept my walruses that dont eat.
some orangutans who your unicorns dont entertain do accept the salamanders.	decl	some orangutans who your unicorns dont entertain do accept the salamanders.
our raven doesnt smile doesnt admire some salamander doesnt smile.	decl	our raven doesnt smile doesnt admire some salamander doesnt smile.
my yak who the peacock doesnt accept does remember your quail does eat.	quest	does my yak who the peacock doesnt accept remember your quail does eat?
the zebra doesnt smile does giggle.	decl	the zebra doesnt smile does giggle.
the xylophone who some orangutans do remember doesnt giggle.	decl	the xylophone who some orangutans do remember doesnt giggle.
the quail doesnt smile does giggle.	decl	the quail doesnt smile does giggle.
our raven that her vultures dont comfort does comfort our tyrannosauruses around her zebra.	decl	our raven that her vultures dont comfort does comfort our tyrannosauruses around her zebra.
my salamander does move doesnt comfort her peacocks that her salamander does admire.	quest	doesnt my salamander does move comfort her peacocks that her salamander does admire?
the quail who our orangutan doesnt confuse doesnt remember our newts that dont change.	quest	doesnt the quail who our orangutan doesnt confuse remember our newts that dont change?
our orangutans that the walrus doesnt admire do entertain some quail who the orangutans do confuse.	decl	our orangutans that the walrus doesnt admire do entertain some quail who the orangutans do confuse.
some quails that dont read dont read.	decl	some quails that dont read dont read.
my orangutans who the raven doesnt comfort do read.	quest	do my orangutans who the raven doesnt comfort read?
my quail that does applaud her salamander doesnt swim.	decl	my quail that does applaud her salamander doesnt swim.
our peacocks that dont applaud the tyrannosauruses do amuse our vulture.	quest	do our peacocks that dont applaud the tyrannosauruses amuse our vulture?
her xylophones that the orangutans do applaud dont applaud your tyrannosaurus.	quest	dont her xylophones that the orangutans do applaud applaud your tyrannosaurus?
her unicorns who my ravens do remember do confuse her tyrannosauruses that do confuse our orangutan.	quest	do her unicorns who my ravens do remember confuse her tyrannosauruses that do confuse our orangutan?
our xylophones that do applaud your xylophone do eat.	quest	do our xylophones that do applaud your xylophone eat?
my orangutans that her newts dont accept do smile.	decl	my orangutans that her newts dont accept do smile.
the newts who your ravens dont amuse dont move.	quest	dont the newts who your ravens dont amuse move?
our peacock who does remember our quails doesnt accept your peacocks that some yaks dont accept.	quest	doesnt our peacock who does remember our quails accept your peacocks that some yaks dont accept?
my tyrannosauruses that dont giggle do amuse the tyrannosaurus by the vulture.	decl	my tyrannosauruses that dont giggle do amuse the tyrannosaurus by the vulture.
my salamanders that some newts dont admire do accept my zebra.	decl	my salamanders that some newts dont admire do accept my zebra.
our salamander doesnt sleep doesnt eat.	quest	doesnt our salamander doesnt sleep eat?
your newts who her xylophone does amuse dont smile.	decl	your newts who her xylophone does amuse dont smile.
our yak that my salamanders do high_five doesnt wait.	decl	our yak that my salamanders do high_five doesnt wait.
your quails who do admire my orangutans dont smile.	decl	your quails who do admire my orangutans dont smile.
our newts who do admire some orangutans dont giggle.	quest	dont our newts who do admire some orangutans giggle?
my newt who does amuse your vulture doesnt remember some raven who my tyrannosauruses do applaud.	decl	my newt who does amuse your vulture doesnt remember some raven who my tyrannosauruses do applaud.
my ravens that your xylophone doesnt remember dont applaud her unicorns.	decl	my ravens that your xylophone doesnt remember dont applaud her unicorns.
my orangutan that your yaks do remember doesnt giggle.	decl	my orangutan that your yaks do remember doesnt giggle.
your ravens who some newt does amuse dont move.	quest	dont your ravens who some newt does amuse move?
your quails who dont move dont entertain my newt that my tyrannosauruses dont comfort.	decl	your quails who dont move dont entertain my newt that my tyrannosauruses dont comfort.
my peacocks that do amuse her zebras do high_five your peacocks.	quest	do my peacocks that do amuse her zebras high_five your peacocks?
our xylophones that some xylophone does accept dont admire my peacock.	quest	dont our xylophones that some xylophone does accept admire my peacock?
her newt who your tyrannosaurus does accept does high_five our newt by the tyrannosauruses.	decl	her newt who your tyrannosaurus does accept does high_five our newt by the tyrannosauruses.
some peacock doesnt eat doesnt smile.	decl	some peacock doesnt eat doesnt smile.
some newt does sleep doesnt sleep.	quest	doesnt some newt does sleep sleep?
the salamanders that do change do swim.	quest	do the salamanders that do change swim?
our xylophone doesnt wait doesnt smile.	quest	doesnt our xylophone doesnt wait smile?
some xylophone does sleep doesnt entertain your xylophones who my xylophones do applaud.	decl	some xylophone does sleep doesnt entertain your xylophones who my xylophones do applaud.
some quail that your peacocks dont high_five does remember your ravens who our peacock does confuse.	quest	does some quail that your peacocks dont high_five remember your ravens who our peacock does confuse?
your salamander that her vulture does amuse doesnt sleep.	decl	your salamander that her vulture does amuse doesnt sleep.
your peacock does read doesnt read.	quest	doesnt your peacock does read read?
the tyrannosauruses who dont sleep do amuse my raven that our quail does amuse.	decl	the tyrannosauruses who dont sleep do amuse my raven that our quail does amuse.
my walruses who my vulture does admire dont read.	decl	my walruses who my vulture does admire dont read.
your salamanders who dont swim dont remember her newt.	decl	your salamanders who dont swim dont remember her newt.
the peacocks who your quails dont high_five dont swim.	quest	dont the peacocks who your quails dont high_five swim?
your ravens who our unicorns do accept dont read.	quest	dont your ravens who our unicorns do accept read?
your ravens who your orangutans dont confuse do amuse some peacock.	decl	your ravens who your orangutans dont confuse do amuse some peacock.
our ravens who our ravens do high_five do giggle.	decl	our ravens who our ravens do high_five do giggle.
our orangutan who your yaks do amuse does move.	decl	our orangutan who your yaks do amuse does move.
my yak that does amuse the ravens doesnt smile.	quest	doesnt my yak that does amuse the ravens smile?
the quail that the quails do high_five does eat.	decl	the quail that the quails do high_five does eat.
your peacocks who dont giggle dont accept her peacocks who her vultures dont admire.	decl	your peacocks who dont giggle dont accept her peacocks who her vultures dont admire.
our zebras who dont high_five your raven do accept your orangutan.	decl	our zebras who dont high_five your raven do accept your orangutan.
your ravens who dont confuse our walruses dont wait.	decl	your ravens who dont confuse our walruses dont wait.
our walruses that do move dont eat.	quest	dont our walruses that do move eat?
the quails that the tyrannosaurus doesnt high_five do giggle.	decl	the quails that the tyrannosaurus doesnt high_five do giggle.
her newts that dont sleep dont sleep.	decl	her newts that dont sleep dont sleep.
the yaks who dont confuse our orangutan do sleep.	decl	the yaks who dont confuse our orangutan do sleep.
the xylophone who some tyrannosaurus doesnt amuse does entertain your quail above our ravens.	decl	the xylophone who some tyrannosaurus doesnt amuse does entertain your quail above our ravens.
our walrus that does amuse some tyrannosaurus does accept the tyrannosauruses.	quest	does our walrus that does amuse some tyrannosaurus accept the tyrannosauruses?
my salamander who your peacock doesnt comfort does admire the unicorns that dont entertain my peacock.	quest	does my salamander who your peacock doesnt comfort admire the unicorns that dont entertain my peacock?
some salamanders that dont remember my orangutan dont eat.	decl	some salamanders that dont remember my orangutan dont eat.
her raven that some newts dont amuse does sleep.	quest	does her raven that some newts dont amuse sleep?
your quail that your vulture doesnt admire does change.	decl	your quail that your vulture doesnt admire does change.
your walrus who does high_five the yak doesnt giggle.	quest	doesnt your walrus who does high_five the yak giggle?
her peacock doesnt sleep doesnt giggle.	decl	her peacock doesnt sleep doesnt giggle.
some salamanders who some tyrannosaurus doesnt entertain dont read.	decl	some salamanders who some tyrannosaurus doesnt entertain dont read.
your vultures that do amuse the tyrannosauruses do smile.	decl	your vultures that do amuse the tyrannosauruses do smile.
my raven who her peacock does entertain doesnt admire some peacock.	quest	doesnt my raven who her peacock does entertain admire some peacock?
your peacock doesnt smile does swim.	decl	your peacock doesnt smile does swim.
our vultures that dont swim do high_five your orangutans.	quest	do our vultures that dont swim high_five your orangutans?
our orangutan who your yak doesnt confuse doesnt giggle.	quest	doesnt our orangutan who your yak doesnt confuse giggle?
the vulture that our raven doesnt entertain does change.	decl	the vulture that our raven doesnt entertain does change.
some yak who doesnt comfort the tyrannosaurus does high_five the newt behind my raven.	quest	does some yak who doesnt comfort the tyrannosaurus high_five the newt behind my raven?
the orangutan who our unicorns dont remember does swim.	decl	the orangutan who our unicorns dont remember does swim.
the xylophones who do entertain your newts dont sleep.	quest	dont the xylophones who do entertain your newts sleep?
my walrus that some ravens do remember doesnt change.	quest	doesnt my walrus that some ravens do remember change?
the raven does wait does applaud some newts.	decl	the raven does wait does applaud some newts.
your peacocks that dont swim dont applaud our tyrannosaurus that some tyrannosauruses do remember.	decl	your peacocks that dont swim dont applaud our tyrannosaurus that some tyrannosauruses do remember.
our salamander who doesnt amuse the raven does high_five some peacock above our ravens.	quest	does our salamander who doesnt amuse the raven high_five some peacock above our ravens?
our peacock doesnt move does eat.	decl	our peacock doesnt move does eat.
my tyrannosauruses that our yaks dont applaud do sleep.	decl	my tyrannosauruses that our yaks dont applaud do sleep.
our newt who the peacock does amuse does comfort our raven.	decl	our newt who the peacock does amuse does comfort our raven.
her quails that your peacock does admire dont giggle.	decl	her quails that your peacock does admire dont giggle.
your raven doesnt read does smile.	decl	your raven doesnt read does smile.
her salamanders that do move do applaud my salamanders with our vulture.	decl	her salamanders that do move do applaud my salamanders with our vulture.
her salamanders who dont sleep dont applaud the newts who my quails dont entertain.	quest	dont her salamanders who dont sleep applaud the newts who my quails dont entertain?
her quails that dont confuse my zebra do applaud her raven doesnt swim.	decl	her quails that dont confuse my zebra do applaud her raven doesnt swim.
her quails who some orangutans do entertain dont move.	decl	her quails who some orangutans do entertain dont move.
my vulture doesnt swim doesnt giggle.	quest	doesnt my vulture doesnt swim giggle?
some zebra that does remember my salamanders does smile.	decl	some zebra that does remember my salamanders does smile.
your tyrannosaurus who does accept my newt doesnt smile.	decl	your tyrannosaurus who does accept my newt doesnt smile.
the vulture who does admire some salamanders does move.	decl	the vulture who does admire some salamanders does move.
the vultures who do amuse some raven dont remember our newts that your unicorn doesnt remember.	decl	the vultures who do amuse some raven dont remember our newts that your unicorn doesnt remember.
the xylophone who our peacocks dont accept does giggle.	decl	the xylophone who our peacocks dont accept does giggle.
the orangutan who her raven does admire doesnt accept her xylophone.	decl	the orangutan who her raven does admire doesnt accept her xylophone.
your vultures that dont comfort our walruses do move.	quest	do your vultures that dont comfort our walruses move?
some newt that doesnt remember her tyrannosaurus does accept the xylophone doesnt wait.	quest	does some newt that doesnt remember her tyrannosaurus accept the xylophone doesnt wait?
your peacocks that her vulture does confuse do move.	decl	your peacocks that her vulture does confuse do move.
our newt who her quail does high_five does sleep.	decl	our newt who her quail does high_five does sleep.
our quail that my newts do remember does wait.	decl	our quail that my newts do remember does wait.
some orangutan that some yak does high_five does confuse her yak by the peacocks.	quest	does some orangutan that some yak does high_five confuse her yak by the peacocks?
some xylophones that dont sleep do change.	quest	do some xylophones that dont sleep change?
some salamander who does admire your zebra does sleep.	decl	some salamander who does admire your zebra does sleep.
our vultures who do eat dont comfort the salamander near the vulture.	quest	dont our vultures who do eat comfort the salamander near the vulture?
my salamanders who her yaks do amuse dont amuse my peacocks above some newts.	quest	dont my salamanders who her yaks do amuse amuse my peacocks above some newts?
her orangutans that do applaud her ravens do remember your quails.	quest	do her orangutans that do applaud her ravens remember your quails?
my orangutan who our tyrannosauruses do confuse does giggle.	quest	does my orangutan who our tyrannosauruses do confuse giggle?
her orangutan that doesnt high_five my orangutans does comfort our unicorns.	decl	her orangutan that doesnt high_five my orangutans does comfort our unicorns.
our newt that your zebra doesnt remember doesnt comfort some tyrannosauruses who do read.	decl	our newt that your zebra doesnt remember doesnt comfort some tyrannosauruses who do read.
the orangutan who doesnt entertain my peacock doesnt comfort some orangutan behind some unicorns.	quest	doesnt the orangutan who doesnt entertain my peacock comfort some orangutan behind some unicorns?
the newt who your quails do high_five does accept some quails.	decl	the newt who your quails do high_five does accept some quails.
your quail that doesnt remember my tyrannosauruses doesnt sleep.	quest	doesnt your quail that doesnt remember my tyrannosauruses sleep?
my ravens who dont amuse her orangutans do amuse my raven.	decl	my ravens who dont amuse her orangutans do amuse my raven.
your xylophones who do swim dont giggle.	decl	your xylophones who do swim dont giggle.
her walrus who your quails do accept does change.	decl	her walrus who your quails do accept does change.
your newts that dont sleep dont confuse my orangutan.	quest	dont your newts that dont sleep confuse my orangutan?
the orangutans that do remember our unicorns do comfort your ravens behind the salamanders.	decl	the orangutans that do remember our unicorns do comfort your ravens behind the salamanders.
some salamander who your salamanders dont confuse does read.	quest	does some salamander who your salamanders dont confuse read?
the quails that dont comfort her yak dont remember our zebra upon the walrus.	decl	the quails that dont comfort her yak dont remember our zebra upon the walrus.
my orangutans who do entertain our quails dont swim.	decl	my orangutans who do entertain our quails dont swim.
our quail who the zebra does comfort doesnt read.	decl	our quail who the zebra does comfort doesnt read.
my peacocks who do sleep dont remember her newts.	decl	my peacocks who do sleep dont remember her newts.
my zebra that does amuse some peacock doesnt change.	quest	doesnt my zebra that does amuse some peacock change?
the yaks that dont high_five your tyrannosauruses do remember some unicorn.	quest	do the yaks that dont high_five your tyrannosauruses remember some unicorn?
my salamander that her orangutans do entertain does confuse your zebras.	quest	does my salamander that her orangutans do entertain confuse your zebras?
your newts that dont giggle dont confuse my peacock.	quest	dont your newts that dont giggle confuse my peacock?
the peacocks that do smile do eat.	quest	do the peacocks that do smile eat?
my tyrannosaurus who does admire your newt does move.	quest	does my tyrannosaurus who does admire your newt move?
some peacock does swim doesnt remember some raven with my newts.	decl	some peacock does swim doesnt remember some raven with my newts.
some salamanders who do confuse the salamanders do remember my raven.	decl	some salamanders who do confuse the salamanders do remember my raven.
my newts that our raven doesnt comfort do swim.	quest	do my newts that our raven doesnt comfort swim?
our vultures that dont sleep do change.	decl	our vultures that dont sleep do change.
your salamander doesnt wait doesnt comfort the newt near her unicorns.	decl	your salamander doesnt wait doesnt comfort the newt near her unicorns.
your tyrannosauruses who my vultures dont entertain do swim.	quest	do your tyrannosauruses who my vultures dont entertain swim?
my salamander that does remember your xylophone does smile.	quest	does my salamander that does remember your xylophone smile?
my newts who do accept our vulture do change.	quest	do my newts who do accept our vulture change?
the orangutan who your unicorn doesnt remember doesnt change.	quest	doesnt the orangutan who your unicorn doesnt remember change?
her peacock that your newt does applaud does confuse my salamander.	decl	her peacock that your newt does applaud does confuse my salamander.
our tyrannosauruses who do admire our ravens dont smile.	quest	dont our tyrannosauruses who do admire our ravens smile?
your walrus who doesnt confuse my ravens does giggle.	quest	does your walrus who doesnt confuse my ravens giggle?
my xylophones who your walrus does admire dont giggle.	decl	my xylophones who your walrus does admire dont giggle.
some ravens who dont entertain my raven dont wait.	quest	dont some ravens who dont entertain my raven wait?
our newts that some salamanders dont comfort dont applaud some tyrannosaurus above your unicorn.	decl	our newts that some salamanders dont comfort dont applaud some tyrannosaurus above your unicorn.
my yak that does admire the ravens does entertain our salamander.	decl	my yak that does admire the ravens does entertain our salamander.
my vultures that some orangutan does amuse dont change.	decl	my vultures that some orangutan does amuse dont change.
her peacock that does accept our yak does smile.	decl	her peacock that does accept our yak does smile.
some raven who her xylophones do applaud doesnt sleep.	decl	some raven who her xylophones do applaud doesnt sleep.
our tyrannosaurus doesnt wait does high_five my walruses near some salamanders.	decl	our tyrannosaurus doesnt wait does high_five my walruses near some salamanders.
her unicorn that some quail does remember does read.	decl	her unicorn that some quail does remember does read.
my tyrannosauruses who dont swim dont change.	decl	my tyrannosauruses who dont swim dont change.
the salamander who does remember some newts doesnt comfort our quail.	decl	the salamander who does remember some newts doesnt comfort our quail.
your walrus who does comfort some unicorns does amuse my raven.	quest	does your walrus who does comfort some unicorns amuse my raven?
our raven that doesnt amuse your orangutan does swim.	decl	our raven that doesnt amuse your orangutan does swim.
our salamander does change doesnt accept our ravens above our newts.	decl	our salamander does change doesnt accept our ravens above our newts.
your orangutans who dont wait dont remember your vultures.	decl	your orangutans who dont wait dont remember your vultures.
the salamanders who her orangutans do entertain dont move.	decl	the salamanders who her orangutans do entertain dont move.
some vulture does change does applaud her salamanders that dont high_five some raven.	quest	does some vulture does change applaud her salamanders that dont high_five some raven?
your salamanders who her newts do admire dont change.	quest	dont your salamanders who her newts do admire change?
our walruses who the yak does entertain do amuse some newts below the yaks.	quest	do our walruses who the yak does entertain amuse some newts below the yaks?
my orangutans who some newt doesnt high_five dont giggle.	quest	dont my orangutans who some newt doesnt high_five giggle?
my walruses who your raven doesnt accept dont change.	decl	my walruses who your raven doesnt accept dont change.
our ravens that dont comfort our zebra dont sleep.	decl	our ravens that dont comfort our zebra dont sleep.
her unicorn who the orangutan does accept doesnt remember our peacocks with our walrus.	quest	doesnt her unicorn who the orangutan does accept remember our peacocks with our walrus?
the vultures that do sleep dont comfort my orangutan.	quest	dont the vultures that do sleep comfort my orangutan?
some newt that does remember her unicorns doesnt entertain my xylophones.	quest	doesnt some newt that does remember her unicorns entertain my xylophones?
some newts that dont swim do change.	decl	some newts that dont swim do change.
the salamanders that your quails do comfort do accept your tyrannosauruses near my peacock.	quest	do the salamanders that your quails do comfort accept your tyrannosauruses near my peacock?
our salamander does sleep does read.	decl	our salamander does sleep does read.
the salamander does giggle does move.	decl	the salamander does giggle does move.
our newts who our vulture does accept dont swim.	decl	our newts who our vulture does accept dont swim.
some orangutans who do entertain our newts do high_five the peacocks who dont swim.	decl	some orangutans who do entertain our newts do high_five the peacocks who dont swim.
our orangutan that our quail does entertain does amuse some newts.	quest	does our orangutan that our quail does entertain amuse some newts?
the unicorns that dont admire my xylophones dont eat.	decl	the unicorns that dont admire my xylophones dont eat.
your tyrannosauruses that her peacock does amuse dont amuse some tyrannosaurus.	quest	dont your tyrannosauruses that her peacock does amuse amuse some tyrannosaurus?
her orangutans who some peacock does high_five do admire my vulture doesnt change.	quest	do her orangutans who some peacock does high_five admire my vulture doesnt change?
our peacocks who dont entertain her xylophone do remember my unicorn.	decl	our peacocks who dont entertain her xylophone do remember my unicorn.
your orangutan does eat does giggle.	decl	your orangutan does eat does giggle.
our orangutan that her tyrannosaurus does remember doesnt entertain the peacock.	decl	our orangutan that her tyrannosaurus does remember doesnt entertain the peacock.
our salamanders who dont admire your yaks do swim.	decl	our salamanders who dont admire your yaks do swim.
her ravens who your xylophone does admire do smile.	decl	her ravens who your xylophone does admire do smile.
my orangutan who her salamanders dont amuse doesnt giggle.	decl	my orangutan who her salamanders dont amuse doesnt giggle.
your zebra that her yak doesnt high_five does applaud the salamanders.	quest	does your zebra that her yak doesnt high_five applaud the salamanders?
some raven who our newts do remember does read.	decl	some raven who our newts do remember does read.
some orangutans that dont eat do entertain her newts.	quest	do some orangutans that dont eat entertain her newts?
her newt does wait doesnt wait.	quest	doesnt her newt does wait wait?
my newt who doesnt amuse her newts does smile.	quest	does my newt who doesnt amuse her newts smile?
some zebras that do amuse my quail do giggle.	quest	do some zebras that do amuse my quail giggle?
the quail who your salamander does entertain doesnt comfort your salamander does move.	decl	the quail who your salamander does entertain doesnt comfort your salamander does move.
my peacocks who some salamanders do amuse do move.	quest	do my peacocks who some salamanders do amuse move?
my walrus who does admire the unicorns doesnt applaud her salamander does read.	quest	doesnt my walrus who does admire the unicorns applaud her salamander does read?
your walrus doesnt change doesnt accept my salamanders.	decl	your walrus doesnt change doesnt accept my salamanders.
your zebra that our peacock doesnt comfort does applaud her orangutans who your orangutan doesnt admire.	quest	does your zebra that our peacock doesnt comfort applaud her orangutans who your orangutan doesnt admire?
her raven who does accept our tyrannosauruses does change.	decl	her raven who does accept our tyrannosauruses does change.
our peacocks who your tyrannosauruses dont amuse dont confuse my unicorn.	decl	our peacocks who your tyrannosauruses dont amuse dont confuse my unicorn.
my orangutan does read doesnt amuse the peacocks who her quail does amuse.	decl	my orangutan does read doesnt amuse the peacocks who her quail does amuse.
the salamander who your peacocks do comfort doesnt read.	decl	the salamander who your peacocks do comfort doesnt read.
her tyrannosauruses who dont giggle dont comfort my peacocks.	quest	dont her tyrannosauruses who dont giggle comfort my peacocks?
the walrus that our ravens do admire doesnt entertain your yaks.	quest	doesnt the walrus that our ravens do admire entertain your yaks?
our tyrannosaurus doesnt change doesnt change.	decl	our tyrannosaurus doesnt change doesnt change.
your quails who my salamanders do confuse do comfort the salamander.	decl	your quails who my salamanders do confuse do comfort the salamander.
the peacock does swim does admire the orangutans who do change.	decl	the peacock does swim does admire the orangutans who do change.
the tyrannosauruses that your newts dont confuse do confuse her peacock who some walrus doesnt accept.	decl	the tyrannosauruses that your newts dont confuse do confuse her peacock who some walrus doesnt accept.
my zebras who dont giggle do high_five her salamander doesnt smile.	decl	my zebras who dont giggle do high_five her salamander doesnt smile.
your tyrannosaurus that your yaks dont amuse does amuse your salamanders around some yak.	quest	does your tyrannosaurus that your yaks dont amuse amuse your salamanders around some yak?
our yaks that my salamander doesnt amuse dont accept my orangutan above the unicorns.	decl	our yaks that my salamander doesnt amuse dont accept my orangutan above the unicorns.
the peacocks that her peacocks dont high_five dont amuse my peacock above my vulture.	decl	the peacocks that her peacocks dont high_five dont amuse my peacock above my vulture.
the newts that dont admire our quails dont comfort the orangutans by our newt.	decl	the newts that dont admire our quails dont comfort the orangutans by our newt.
your orangutan does eat doesnt entertain the ravens that do giggle.	decl	your orangutan does eat doesnt entertain the ravens that do giggle.
some tyrannosaurus that doesnt confuse your salamander does wait.	quest	does some tyrannosaurus that doesnt confuse your salamander wait?
our salamander who doesnt remember our raven does giggle.	quest	does our salamander who doesnt remember our raven giggle?
our tyrannosaurus who my tyrannosauruses dont accept doesnt confuse our peacock.	quest	doesnt our tyrannosaurus who my tyrannosauruses dont accept confuse our peacock?
my tyrannosauruses who some zebra doesnt entertain do admire our salamanders that your zebra doesnt high_five.	decl	my tyrannosauruses who some zebra doesnt entertain do admire our salamanders that your zebra doesnt high_five.
the newt who does entertain her ravens does entertain the vulture with my yaks.	decl	the newt who does entertain her ravens does entertain the vulture with my yaks.
her peacock that doesnt remember our quails does giggle.	quest	does her peacock that doesnt remember our quails giggle?
some quail does change does applaud my peacocks.	quest	does some quail does change applaud my peacocks?
some peacock that the quails dont comfort does high_five my raven around some raven.	quest	does some peacock that the quails dont comfort high_five my raven around some raven?
some tyrannosaurus who doesnt applaud my raven doesnt applaud my yak that my peacocks do applaud.	quest	doesnt some tyrannosaurus who doesnt applaud my raven applaud my yak that my peacocks do applaud?
some unicorn who the tyrannosaurus doesnt applaud does sleep.	quest	does some unicorn who the tyrannosaurus doesnt applaud sleep?
her unicorn who doesnt confuse the quails does remember her tyrannosauruses.	quest	does her unicorn who doesnt confuse the quails remember her tyrannosauruses?
the salamanders who do remember her tyrannosaurus dont read.	quest	dont the salamanders who do remember her tyrannosaurus read?
some raven who my peacock doesnt confuse does accept my peacock.	decl	some raven who my peacock doesnt confuse does accept my peacock.
some quail doesnt smile doesnt move.	decl	some quail doesnt smile doesnt move.
our xylophones that her xylophone doesnt remember do sleep.	quest	do our xylophones that her xylophone doesnt remember sleep?
our yak who some unicorn doesnt amuse does admire your vultures.	quest	does our yak who some unicorn doesnt amuse admire your vultures?
some salamanders that our yaks do applaud dont sleep.	decl	some salamanders that our yaks do applaud dont sleep.
my zebra who does entertain some newts doesnt remember the peacock with our raven.	quest	doesnt my zebra who does entertain some newts remember the peacock with our raven?
my vultures who do move dont entertain my peacocks.	quest	dont my vultures who do move entertain my peacocks?
our quail who does amuse our tyrannosauruses does confuse our raven does move.	decl	our quail who does amuse our tyrannosauruses does confuse our raven does move.
my walruses who dont smile dont swim.	quest	dont my walruses who dont smile swim?
some salamanders that our newts dont comfort dont giggle.	quest	dont some salamanders that our newts dont comfort giggle?
her tyrannosaurus does sleep doesnt wait.	quest	doesnt her tyrannosaurus does sleep wait?
your peacock that her unicorns do entertain doesnt applaud some salamanders behind my orangutan.	quest	doesnt your peacock that her unicorns do entertain applaud some salamanders behind my orangutan?
your tyrannosaurus who my salamanders dont amuse does high_five the quails behind my vulture.	decl	your tyrannosaurus who my salamanders dont amuse does high_five the quails behind my vulture.
your newts who dont comfort my newt do smile.	quest	do your newts who dont comfort my newt smile?
some quails who the peacocks do admire do wait.	decl	some quails who the peacocks do admire do wait.
my quail that our newt doesnt entertain doesnt accept my xylophones with the peacocks.	quest	doesnt my quail that our newt doesnt entertain accept my xylophones with the peacocks?
the raven that my peacocks dont admire doesnt entertain the newt who does comfort her salamanders.	decl	the raven that my peacocks dont admire doesnt entertain the newt who does comfort her salamanders.
your tyrannosauruses who dont high_five our newts do giggle.	quest	do your tyrannosauruses who dont high_five our newts giggle?
our vultures who our newts do accept dont accept her ravens.	decl	our vultures who our newts do accept dont accept her ravens.
some orangutan who doesnt amuse the zebras doesnt remember your tyrannosaurus.	decl	some orangutan who doesnt amuse the zebras doesnt remember your tyrannosaurus.
my orangutan that does comfort my xylophone doesnt amuse our peacock around some unicorn.	quest	doesnt my orangutan that does comfort my xylophone amuse our peacock around some unicorn?
her xylophone who your quails dont entertain does accept our peacock who your orangutans do admire.	quest	does her xylophone who your quails dont entertain accept our peacock who your orangutans do admire?
her quail that my tyrannosaurus doesnt high_five does eat.	decl	her quail that my tyrannosaurus doesnt high_five does eat.
the newts that do wait do wait.	decl	the newts that do wait do wait.
the tyrannosauruses who do amuse our newt dont swim.	decl	the tyrannosauruses who do amuse our newt dont swim.
my newt who does entertain my yak does giggle.	quest	does my newt who does entertain my yak giggle?
her peacock that my unicorn does admire does applaud your peacock upon your peacock.	quest	does her peacock that my unicorn does admire applaud your peacock upon your peacock?
my peacocks who do accept some vultures do eat.	quest	do my peacocks who do accept some vultures eat?
my unicorns who dont admire some tyrannosauruses do applaud some peacocks that your orangutan doesnt high_five.	decl	my unicorns who dont admire some tyrannosauruses do applaud some peacocks that your orangutan doesnt high_five.
your orangutans who dont high_five your walrus do comfort my vulture.	quest	do your orangutans who dont high_five your walrus comfort my vulture?
her salamander who does admire my unicorn doesnt swim.	decl	her salamander who does admire my unicorn doesnt swim.
her orangutans who your peacock doesnt confuse dont change.	decl	her orangutans who your peacock doesnt confuse dont change.
our orangutans that do giggle dont confuse her newts.	quest	dont our orangutans that do giggle confuse her newts?
some unicorns who some salamander does high_five do accept our yak around her orangutan.	quest	do some unicorns who some salamander does high_five accept our yak around her orangutan?
her ravens that her raven does high_five dont amuse your tyrannosaurus.	decl	her ravens that her raven does high_five dont amuse your tyrannosaurus.
your raven does giggle does swim.	quest	does your raven does giggle swim?
my newts who her salamanders dont comfort do applaud her tyrannosauruses who do confuse my quails.	decl	my newts who her salamanders dont comfort do applaud her tyrannosauruses who do confuse my quails.
your newts who dont confuse our zebra do eat.	decl	your newts who dont confuse our zebra do eat.
your vulture who does comfort the newts doesnt swim.	decl	your vulture who does comfort the newts doesnt swim.
her quail doesnt giggle does confuse some newt that our newts dont applaud.	decl	her quail doesnt giggle does confuse some newt that our newts dont applaud.
my orangutans who some zebra does comfort dont confuse our salamander.	quest	dont my orangutans who some zebra does comfort confuse our salamander?
her ravens that dont admire our xylophones dont accept our quail by the walrus.	decl	her ravens that dont admire our xylophones dont accept our quail by the walrus.
our unicorns that dont remember her quails do sleep.	decl	our unicorns that dont remember her quails do sleep.
the ravens who dont move dont amuse the yaks behind some tyrannosaurus.	quest	dont the ravens who dont move amuse the yaks behind some tyrannosaurus?
her walrus who does remember our vulture does eat.	quest	does her walrus who does remember our vulture eat?
my raven that doesnt accept some unicorn doesnt applaud her newts.	quest	doesnt my raven that doesnt accept some unicorn applaud her newts?
some salamander who her peacocks do amuse does amuse our quails behind our yak.	decl	some salamander who her peacocks do amuse does amuse our quails behind our yak.
my tyrannosaurus that doesnt accept your salamanders does comfort the quails with our quail.	decl	my tyrannosaurus that doesnt accept your salamanders does comfort the quails with our quail.
her xylophone that does applaud her zebras doesnt move.	decl	her xylophone that does applaud her zebras doesnt move.
the raven that my quails dont high_five does applaud your tyrannosaurus doesnt sleep.	quest	does the raven that my quails dont high_five applaud your tyrannosaurus doesnt sleep?
her raven that doesnt comfort my xylophones doesnt swim.	decl	her raven that doesnt comfort my xylophones doesnt swim.
our orangutans that your peacocks dont high_five dont giggle.	decl	our orangutans that your peacocks dont high_five dont giggle.
the tyrannosauruses that dont smile do applaud some tyrannosaurus.	quest	do the tyrannosauruses that dont smile applaud some tyrannosaurus?
the zebras who do high_five my salamanders dont comfort your orangutan upon my salamander.	quest	dont the zebras who do high_five my salamanders comfort your orangutan upon my salamander?
some unicorn who does entertain her vultures does read.	decl	some unicorn who does entertain her vultures does read.
your orangutan doesnt swim does amuse the salamanders.	decl	your orangutan doesnt swim does amuse the salamanders.
the tyrannosaurus does smile does giggle.	quest	does the tyrannosaurus does smile giggle?
my orangutan doesnt swim does comfort her ravens that some tyrannosauruses dont admire.	decl	my orangutan doesnt swim does comfort her ravens that some tyrannosauruses dont admire.
our orangutans that do high_five some peacock dont high_five my ravens.	decl	our orangutans that do high_five some peacock dont high_five my ravens.
the ravens who some newt doesnt entertain dont move.	decl	the ravens who some newt doesnt entertain dont move.
her tyrannosauruses that do confuse her zebra do smile.	decl	her tyrannosauruses that do confuse her zebra do smile.
my newt does read does remember some zebras near her quails.	quest	does my newt does read remember some zebras near her quails?
some ravens that do entertain your orangutan do giggle.	quest	do some ravens that do entertain your orangutan giggle?
our tyrannosauruses that our zebra doesnt high_five do applaud her newts.	quest	do our tyrannosauruses that our zebra doesnt high_five applaud her newts?
some orangutans who dont admire our tyrannosaurus do read.	quest	do some orangutans who dont admire our tyrannosaurus read?
the orangutans that some tyrannosaurus does amuse do remember your salamanders with some newt.	quest	do the orangutans that some tyrannosaurus does amuse remember your salamanders with some newt?
our peacock who doesnt applaud the peacock does high_five your unicorn above my orangutans.	decl	our peacock who doesnt applaud the peacock does high_five your unicorn above my orangutans.
our orangutan does eat doesnt high_five the orangutans that her raven doesnt admire.	quest	doesnt our orangutan does eat high_five the orangutans that her raven doesnt admire?
your salamanders who do high_five the vultures dont eat.	decl	your salamanders who do high_five the vultures dont eat.
the orangutans that her peacocks do comfort dont comfort her newts around my salamander.	decl	the orangutans that her peacocks do comfort dont comfort her newts around my salamander.
our quail that some zebra doesnt high_five does swim.	quest	does our quail that some zebra doesnt high_five swim?
her vultures that the newts dont remember do admire my walruses upon our peacock.	decl	her vultures that the newts dont remember do admire my walruses upon our peacock.
her walrus who doesnt accept your xylophone doesnt eat.	quest	doesnt her walrus who doesnt accept your xylophone eat?
our peacock that my walrus doesnt entertain doesnt swim.	quest	doesnt our peacock that my walrus doesnt entertain swim?
some yak doesnt sleep does read.	decl	some yak doesnt sleep does read.
my quail who doesnt remember your newts does entertain my quails that dont entertain her zebras.	decl	my quail who doesnt remember your newts does entertain my quails that dont entertain her zebras.
your quail who our orangutan doesnt amuse doesnt sleep.	quest	doesnt your quail who our orangutan doesnt amuse sleep?
her tyrannosaurus who our newts do amuse does high_five her orangutan with some peacock.	quest	does her tyrannosaurus who our newts do amuse high_five her orangutan with some peacock?
her tyrannosaurus does eat doesnt entertain her orangutan.	quest	doesnt her tyrannosaurus does eat entertain her orangutan?
our peacock who does applaud your xylophone does sleep.	quest	does our peacock who does applaud your xylophone sleep?
our newt who does accept her salamander doesnt accept our peacock who the quails dont confuse.	decl	our newt who does accept her salamander doesnt accept our peacock who the quails dont confuse.
my quail that her unicorns do comfort doesnt high_five my ravens with your quails.	quest	doesnt my quail that her unicorns do comfort high_five my ravens with your quails?
the salamander who doesnt accept some peacock does eat.	quest	does the salamander who doesnt accept some peacock eat?
our raven who doesnt entertain the zebra doesnt move.	decl	our raven who doesnt entertain the zebra doesnt move.
the tyrannosaurus that the newt does amuse does move.	quest	does the tyrannosaurus that the newt does amuse move?
some tyrannosauruses who do smile do change.	quest	do some tyrannosauruses who do smile change?
your tyrannosauruses who do wait do sleep.	decl	your tyrannosauruses who do wait do sleep.
your vulture who does admire some orangutans doesnt swim.	decl	your vulture who does admire some orangutans doesnt swim.
some tyrannosauruses who your peacocks dont accept do sleep.	quest	do some tyrannosauruses who your peacocks dont accept sleep?
your tyrannosaurus that does remember her newt doesnt accept some unicorns with her unicorn.	decl	your tyrannosaurus that does remember her newt doesnt accept some unicorns with her unicorn.
our ravens that the quails do admire do entertain her peacock does read.	decl	our ravens that the quails do admire do entertain her peacock does read.
my orangutans that do eat dont confuse your peacock near some newt.	decl	my orangutans that do eat dont confuse your peacock near some newt.
some salamanders who dont move dont sleep.	quest	dont some salamanders who dont move sleep?
our yaks who my quail doesnt comfort do amuse our zebra upon the newts.	decl	our yaks who my quail doesnt comfort do amuse our zebra upon the newts.
her tyrannosaurus who our newts dont accept does wait.	decl	her tyrannosaurus who our newts dont accept does wait.
my newts who some unicorn does amuse dont wait.	quest	dont my newts who some unicorn does amuse wait?
your salamanders who dont read dont giggle.	decl	your salamanders who dont read dont giggle.
some quails that do swim dont high_five some quails.	quest	dont some quails that do swim high_five some quails?
her ravens who our vulture doesnt entertain dont change.	decl	her ravens who our vulture doesnt entertain dont change.
my orangutan who your yak does entertain does high_five my peacock near her salamanders.	decl	my orangutan who your yak does entertain does high_five my peacock near her salamanders.
our raven who does high_five my newt does accept the tyrannosaurus upon some salamander.	quest	does our raven who does high_five my newt accept the tyrannosaurus upon some salamander?
my unicorns who do high_five my peacocks do remember her vulture does move.	quest	do my unicorns who do high_five my peacocks remember her vulture does move?
my newt does read doesnt accept our newt that the newt doesnt amuse.	quest	doesnt my newt does read accept our newt that the newt doesnt amuse?
my salamanders who her vulture doesnt remember dont swim.	decl	my salamanders who her vulture doesnt remember dont swim.
your yaks that do wait do applaud some yak near the tyrannosauruses.	decl	your yaks that do wait do applaud some yak near the tyrannosauruses.
your raven who our salamanders do applaud does wait.	decl	your raven who our salamanders do applaud does wait.
my newts who dont confuse some xylophone do move.	quest	do my newts who dont confuse some xylophone move?
your quail that does applaud our tyrannosaurus does smile.	quest	does your quail that does applaud our tyrannosaurus smile?
her raven who does accept my unicorns does sleep.	quest	does her raven who does accept my unicorns sleep?
your orangutan doesnt swim does accept my raven.	decl	your orangutan doesnt swim does accept my raven.
your salamander that some tyrannosaurus does entertain doesnt swim.	quest	doesnt your salamander that some tyrannosaurus does entertain swim?
your quails that dont admire our orangutans dont remember my tyrannosauruses with her salamander.	quest	dont your quails that dont admire our orangutans remember my tyrannosauruses with her salamander?
the salamander who the orangutan doesnt remember does remember the peacock.	decl	the salamander who the orangutan doesnt remember does remember the peacock.
her newt doesnt read doesnt remember our newts.	decl	her newt doesnt read doesnt remember our newts.
your ravens that do sleep do eat.	quest	do your ravens that do sleep eat?
some newt doesnt change doesnt move.	quest	doesnt some newt doesnt change move?
our quail who our tyrannosauruses dont admire does remember your yaks that do change.	quest	does our quail who our tyrannosauruses dont admire remember your yaks that do change?
our yak that the newt doesnt amuse doesnt amuse my raven that your tyrannosauruses do applaud.	quest	doesnt our yak that the newt doesnt amuse amuse my raven that your tyrannosauruses do applaud?
our quail who does accept our newts doesnt sleep.	decl	our quail who does accept our newts doesnt sleep.
her tyrannosaurus who my peacock does comfort does swim.	decl	her tyrannosaurus who my peacock does comfort does swim.
your salamander that doesnt high_five her xylophones doesnt entertain the unicorns above some newt.	decl	your salamander that doesnt high_five her xylophones doesnt entertain the unicorns above some newt.
my quail that does confuse your ravens does change.	quest	does my quail that does confuse your ravens change?
her salamander does sleep does entertain her tyrannosauruses.	quest	does her salamander does sleep entertain her tyrannosauruses?
our quails who some peacock does amuse do remember some quails around my orangutans.	decl	our quails who some peacock does amuse do remember some quails around my orangutans.
some zebra that doesnt admire some orangutans doesnt remember her peacock doesnt change.	quest	doesnt some zebra that doesnt admire some orangutans remember her peacock doesnt change?
her newt that her peacock does entertain does sleep.	decl	her newt that her peacock does entertain does sleep.
her quails that her peacock does entertain do eat.	decl	her quails that her peacock does entertain do eat.
our raven who doesnt accept my unicorn does accept our peacocks.	quest	does our raven who doesnt accept my unicorn accept our peacocks?
our unicorn that our quails do amuse does swim.	quest	does our unicorn that our quails do amuse swim?
my peacock who her unicorn does high_five doesnt amuse the vultures near my tyrannosaurus.	quest	doesnt my peacock who her unicorn does high_five amuse the vultures near my tyrannosaurus?
my salamander that the xylophones dont confuse doesnt smile.	quest	doesnt my salamander that the xylophones dont confuse smile?
our peacock that my salamander doesnt comfort does sleep.	quest	does our peacock that my salamander doesnt comfort sleep?
your quail who does admire her walrus doesnt comfort her walrus upon our raven.	quest	doesnt your quail who does admire her walrus comfort her walrus upon our raven?
the newt who does admire the zebra doesnt accept her tyrannosaurus.	decl	the newt who does admire the zebra doesnt accept her tyrannosaurus.
some raven who the quails dont entertain doesnt comfort our zebras that do eat.	quest	doesnt some raven who the quails dont entertain comfort our zebras that do eat?
some orangutans who the peacocks dont confuse dont comfort some orangutans who our tyrannosaurus doesnt comfort.	decl	some orangutans who the peacocks dont confuse dont comfort some orangutans who our tyrannosaurus doesnt comfort.
some newts who your salamander doesnt comfort dont sleep.	quest	dont some newts who your salamander doesnt comfort sleep?
her peacocks who dont confuse my newt do accept my zebra.	decl	her peacocks who dont confuse my newt do accept my zebra.
some xylophone doesnt eat doesnt comfort my orangutans.	decl	some xylophone doesnt eat doesnt comfort my orangutans.
your orangutan who the salamander doesnt applaud doesnt eat.	decl	your orangutan who the salamander doesnt applaud doesnt eat.
your orangutans that your tyrannosaurus doesnt amuse do amuse my unicorns who our walrus does accept.	quest	do your orangutans that your tyrannosaurus doesnt amuse amuse my unicorns who our walrus does accept?
the quails who my orangutan does accept do sleep.	quest	do the quails who my orangutan does accept sleep?
some orangutans that do giggle do change.	decl	some orangutans that do giggle do change.
our raven doesnt read doesnt entertain our tyrannosauruses.	quest	doesnt our raven doesnt read entertain our tyrannosauruses?
some ravens that do eat do applaud my quails above your quail.	quest	do some ravens that do eat applaud my quails above your quail?
some quail that our quails dont accept doesnt change.	quest	doesnt some quail that our quails dont accept change?
some peacock that your quail doesnt high_five doesnt swim.	decl	some peacock that your quail doesnt high_five doesnt swim.
the yak does read doesnt smile.	quest	doesnt the yak does read smile?
some walrus that my peacock does admire doesnt eat.	quest	doesnt some walrus that my peacock does admire eat?
your peacock doesnt swim doesnt sleep.	quest	doesnt your peacock doesnt swim sleep?
our salamanders that dont move dont giggle.	decl	our salamanders that dont move dont giggle.
your zebras that some newt doesnt comfort do comfort your tyrannosauruses.	quest	do your zebras that some newt doesnt comfort comfort your tyrannosauruses?
her ravens who dont sleep dont eat.	quest	dont her ravens who dont sleep eat?
my peacocks that dont swim dont accept your raven.	quest	dont my peacocks that dont swim accept your raven?
her orangutan does wait doesnt entertain the ravens.	decl	her orangutan does wait doesnt entertain the ravens.
my tyrannosaurus that the orangutan doesnt applaud doesnt move.	decl	my tyrannosaurus that the orangutan doesnt applaud doesnt move.
your unicorns that some ravens do confuse dont change.	decl	your unicorns that some ravens do confuse dont change.
my xylophones who do accept her quail dont swim.	decl	my xylophones who do accept her quail dont swim.
your peacock that doesnt accept some peacocks doesnt applaud some orangutans below the quails.	decl	your peacock that doesnt accept some peacocks doesnt applaud some orangutans below the quails.
the peacocks who do smile dont remember some quails above my walrus.	decl	the peacocks who do smile dont remember some quails above my walrus.
your xylophones who dont entertain some yaks dont eat.	quest	dont your xylophones who dont entertain some yaks eat?
your vultures that dont high_five the vultures dont entertain our ravens that dont move.	decl	your vultures that dont high_five the vultures dont entertain our ravens that dont move.
her orangutan who our newts do comfort does remember my salamander who does confuse her tyrannosauruses.	quest	does her orangutan who our newts do comfort remember my salamander who does confuse her tyrannosauruses?
her newts that some peacocks dont high_five do smile.	quest	do her newts that some peacocks dont high_five smile?
my newts who do high_five your salamander do move.	decl	my newts who do high_five your salamander do move.
your walrus does giggle doesnt admire my xylophone does move.	decl	your walrus does giggle doesnt admire my xylophone does move.
our vultures who our yaks do high_five dont entertain our zebras that our orangutans dont admire.	quest	dont our vultures who our yaks do high_five entertain our zebras that our orangutans dont admire?
my peacocks that her zebras dont accept do wait.	quest	do my peacocks that her zebras dont accept wait?
the unicorns that your raven doesnt admire dont move.	quest	dont the unicorns that your raven doesnt admire move?
our unicorns who dont applaud her orangutan dont high_five some newts.	quest	dont our unicorns who dont applaud her orangutan high_five some newts?
her walruses that her xylophones do entertain do sleep.	decl	her walruses that her xylophones do entertain do sleep.
your quail that my walruses dont high_five doesnt admire some vultures.	quest	doesnt your quail that my walruses dont high_five admire some vultures?
our ravens who do move dont move.	quest	dont our ravens who do move move?
our zebra doesnt move doesnt swim.	quest	doesnt our zebra doesnt move swim?
some zebras who dont high_five the tyrannosaurus do remember her raven by her zebras.	quest	do some zebras who dont high_five the tyrannosaurus remember her raven by her zebras?
my xylophones that do wait dont high_five our xylophones who dont wait.	quest	dont my xylophones that do wait high_five our xylophones who dont wait?
the zebra who doesnt remember her quail does read.	quest	does the zebra who doesnt remember her quail read?
the vultures that your quails dont accept dont remember some salamanders around some xylophones.	decl	the vultures that your quails dont accept dont remember some salamanders around some xylophones.
my vulture who her unicorn does high_five does remember our salamander who my newt does accept.	quest	does my vulture who her unicorn does high_five remember our salamander who my newt does accept?
my salamanders who do move dont move.	quest	dont my salamanders who do move move?
my salamander does smile does move.	quest	does my salamander does smile move?
our orangutan who does accept her salamander does applaud my peacocks near my zebras.	decl	our orangutan who does accept her salamander does applaud my peacocks near my zebras.
the salamander that some raven doesnt applaud doesnt move.	quest	doesnt the salamander that some raven doesnt applaud move?
some quails that our newt doesnt entertain dont high_five the yak that does admire her newt.	decl	some quails that our newt doesnt entertain dont high_five the yak that does admire her newt.
my peacock does move doesnt wait.	quest	doesnt my peacock does move wait?
our peacocks who do read dont change.	quest	dont our peacocks who do read change?
my orangutan who doesnt amuse some tyrannosaurus doesnt amuse some tyrannosauruses behind my zebra.	decl	my orangutan who doesnt amuse some tyrannosaurus doesnt amuse some tyrannosauruses behind my zebra.
my xylophone does eat doesnt wait.	quest	doesnt my xylophone does eat wait?
her tyrannosauruses who dont wait dont applaud her walrus below the salamander.	quest	dont her tyrannosauruses who dont wait applaud her walrus below the salamander?
the tyrannosaurus who doesnt comfort our orangutans doesnt confuse her tyrannosaurus that my raven doesnt comfort.	quest	doesnt the tyrannosaurus who doesnt comfort our orangutans confuse her tyrannosaurus that my raven doesnt comfort?
her newt that my orangutans dont high_five doesnt confuse some walrus doesnt giggle.	quest	doesnt her newt that my orangutans dont high_five confuse some walrus doesnt giggle?
some raven that does remember my peacock doesnt accept your unicorn.	quest	doesnt some raven that does remember my peacock accept your unicorn?
the zebra that does entertain her tyrannosauruses doesnt smile.	quest	doesnt the zebra that does entertain her tyrannosauruses smile?
some orangutan who does high_five my newt does comfort some raven who my quails do high_five.	quest	does some orangutan who does high_five my newt comfort some raven who my quails do high_five?
your vulture that my raven does high_five does eat.	decl	your vulture that my raven does high_five does eat.
some orangutan that your peacocks do accept doesnt comfort her unicorn that the salamander doesnt accept.	quest	doesnt some orangutan that your peacocks do accept comfort her unicorn that the salamander doesnt accept?
some peacocks who our newts do admire do change.	decl	some peacocks who our newts do admire do change.
her salamanders that do amuse her walrus dont remember some orangutans near the walrus.	decl	her salamanders that do amuse her walrus dont remember some orangutans near the walrus.
your raven doesnt eat doesnt smile.	decl	your raven doesnt eat doesnt smile.
our quail that the newts dont amuse does change.	decl	our quail that the newts dont amuse does change.
some newt who your orangutan doesnt confuse does admire some walrus that does remember our orangutans.	quest	does some newt who your orangutan doesnt confuse admire some walrus that does remember our orangutans?
her unicorns who our newt does amuse dont read.	quest	dont her unicorns who our newt does amuse read?
my tyrannosauruses who dont confuse your tyrannosaurus dont swim.	decl	my tyrannosauruses who dont confuse your tyrannosaurus dont swim.
the newt doesnt swim does remember my xylophones who our zebra does admire.	quest	does the newt doesnt swim remember my xylophones who our zebra does admire?
my raven who doesnt amuse her tyrannosauruses does smile.	decl	my raven who doesnt amuse her tyrannosauruses does smile.
my raven who my orangutans do entertain doesnt entertain my yaks.	decl	my raven who my orangutans do entertain doesnt entertain my yaks.
the salamanders who our peacocks do high_five dont wait.	decl	the salamanders who our peacocks do high_five dont wait.
your zebras who the vultures dont entertain do applaud my newts.	decl	your zebras who the vultures dont entertain do applaud my newts.
our vultures that do read do smile.	decl	our vultures that do read do smile.
our peacock who some unicorns do amuse does move.	quest	does our peacock who some unicorns do amuse move?
the salamanders who do smile dont remember my yak.	decl	the salamanders who do smile dont remember my yak.
some ravens who do wait dont giggle.	quest	dont some ravens who do wait giggle?
our quail doesnt move doesnt read.	decl	our quail doesnt move doesnt read.
my walruses that dont read dont entertain my newts below my xylophone.	quest	dont my walruses that dont read entertain my newts below my xylophone?
the tyrannosaurus that the xylophone does admire doesnt high_five my salamanders that our newts dont accept.	decl	the tyrannosaurus that the xylophone does admire doesnt high_five my salamanders that our newts dont accept.
my salamander doesnt eat doesnt wait.	quest	doesnt my salamander doesnt eat wait?
my unicorns that dont remember her walruses do accept some raven who your salamanders dont confuse.	quest	do my unicorns that dont remember her walruses accept some raven who your salamanders dont confuse?
our orangutan does sleep does accept her orangutans around my vultures.	decl	our orangutan does sleep does accept her orangutans around my vultures.
the quail that your newt does comfort does move.	decl	the quail that your newt does comfort does move.
my peacocks that my quail does high_five dont amuse the raven behind our tyrannosaurus.	quest	dont my peacocks that my quail does high_five amuse the raven behind our tyrannosaurus?
some ravens that dont wait do change.	decl	some ravens that dont wait do change.
your raven that her vultures do amuse does admire some tyrannosaurus near some newts.	decl	your raven that her vultures do amuse does admire some tyrannosaurus near some newts.
the orangutans that her tyrannosaurus does entertain dont swim.	quest	dont the orangutans that her tyrannosaurus does entertain swim?
our quails who your vultures dont remember dont wait.	decl	our quails who your vultures dont remember dont wait.
my orangutans who our salamander doesnt comfort dont remember her newts below her peacocks.	quest	dont my orangutans who our salamander doesnt comfort remember her newts below her peacocks?
your orangutan that doesnt high_five my vultures does amuse your salamanders that dont move.	quest	does your orangutan that doesnt high_five my vultures amuse your salamanders that dont move?
our peacock that doesnt applaud my peacock doesnt move.	decl	our peacock that doesnt applaud my peacock doesnt move.
some peacocks that her raven does remember dont entertain her walruses.	decl	some peacocks that her raven does remember dont entertain her walruses.
the vultures that the orangutan does admire dont swim.	quest	dont the vultures that the orangutan does admire swim?
my newt that our newt doesnt high_five doesnt change.	quest	doesnt my newt that our newt doesnt high_five change?
your quail that some vulture doesnt confuse does read.	quest	does your quail that some vulture doesnt confuse read?
your orangutan doesnt move does amuse your newts upon her tyrannosauruses.	quest	does your orangutan doesnt move amuse your newts upon her tyrannosauruses?
my orangutans who do comfort my zebras dont smile.	decl	my orangutans who do comfort my zebras dont smile.
our peacocks who some salamanders dont amuse dont giggle.	decl	our peacocks who some salamanders dont amuse dont giggle.
some salamanders that dont remember our quails do swim.	decl	some salamanders that dont remember our quails do swim.
her zebra doesnt eat doesnt applaud my raven below the tyrannosaurus.	decl	her zebra doesnt eat doesnt applaud my raven below the tyrannosaurus.
her salamander does eat does giggle.	quest	does her salamander does eat giggle?
the newt does read does applaud the salamanders that my quail doesnt accept.	decl	the newt does read does applaud the salamanders that my quail doesnt accept.
her vultures that do move dont applaud your peacocks that dont change.	decl	her vultures that do move dont applaud your peacocks that dont change.
her tyrannosauruses that my unicorns do high_five do high_five my vultures.	decl	her tyrannosauruses that my unicorns do high_five do high_five my vultures.
my tyrannosaurus that does high_five her salamanders doesnt wait.	decl	my tyrannosaurus that does high_five her salamanders doesnt wait.
some newts that my peacock doesnt admire dont wait.	quest	dont some newts that my peacock doesnt admire wait?
your unicorns who our unicorns do entertain dont amuse the newts.	quest	dont your unicorns who our unicorns do entertain amuse the newts?
some salamander that the salamanders dont confuse does accept my quail by some xylophones.	quest	does some salamander that the salamanders dont confuse accept my quail by some xylophones?
the unicorn who doesnt high_five our zebra doesnt high_five my tyrannosauruses.	quest	doesnt the unicorn who doesnt high_five our zebra high_five my tyrannosauruses?
my tyrannosaurus that does applaud some xylophone doesnt sleep.	decl	my tyrannosaurus that does applaud some xylophone doesnt sleep.
the ravens who dont confuse some orangutans dont wait.	quest	dont the ravens who dont confuse some orangutans wait?
the vulture who the peacock does amuse doesnt admire some tyrannosaurus.	decl	the vulture who the peacock does amuse doesnt admire some tyrannosaurus.
her salamanders who dont amuse her salamander do smile.	decl	her salamanders who dont amuse her salamander do smile.
my peacocks who your walrus doesnt entertain do applaud the walruses.	decl	my peacocks who your walrus doesnt entertain do applaud the walruses.
our yaks that do giggle do eat.	decl	our yaks that do giggle do eat.
your zebra does swim does entertain her orangutan above my newt.	quest	does your zebra does swim entertain her orangutan above my newt?
your newts that dont swim do swim.	decl	your newts that dont swim do swim.
some zebras who your orangutan doesnt high_five do comfort my xylophone upon your ravens.	decl	some zebras who your orangutan doesnt high_five do comfort my xylophone upon your ravens.
my peacock who my ravens dont high_five doesnt smile.	quest	doesnt my peacock who my ravens dont high_five smile?
our ravens who dont amuse some tyrannosauruses do admire some peacocks who some raven does accept.	quest	do our ravens who dont amuse some tyrannosauruses admire some peacocks who some raven does accept?
her yak that does amuse the walrus doesnt amuse the raven that does admire our quails.	decl	her yak that does amuse the walrus doesnt amuse the raven that does admire our quails.
her unicorn who the tyrannosauruses do amuse does high_five my orangutan that your peacocks dont high_five.	quest	does her unicorn who the tyrannosauruses do amuse high_five my orangutan that your peacocks dont high_five?
some newts who the orangutan doesnt entertain do high_five my orangutans.	decl	some newts who the orangutan doesnt entertain do high_five my orangutans.
her salamander that does applaud your walruses doesnt remember our raven around my newt.	quest	doesnt her salamander that does applaud your walruses remember our raven around my newt?
her ravens who dont remember our xylophones dont swim.	quest	dont her ravens who dont remember our xylophones swim?
her raven that your newt doesnt accept doesnt giggle.	decl	her raven that your newt doesnt accept doesnt giggle.
her peacock does change doesnt high_five the tyrannosaurus with our unicorn.	decl	her peacock does change doesnt high_five the tyrannosaurus with our unicorn.
my raven doesnt smile doesnt amuse my zebras by the unicorn.	quest	doesnt my raven doesnt smile amuse my zebras by the unicorn?
our vulture does read does applaud the newt who my tyrannosaurus doesnt confuse.	decl	our vulture does read does applaud the newt who my tyrannosaurus doesnt confuse.
her raven doesnt wait does comfort some salamanders that dont confuse your orangutans.	decl	her raven doesnt wait does comfort some salamanders that dont confuse your orangutans.
our newt who the yaks do admire doesnt comfort her salamander does swim.	decl	our newt who the yaks do admire doesnt comfort her salamander does swim.
our newts that our salamanders dont comfort do admire your raven by our zebra.	decl	our newts that our salamanders dont comfort do admire your raven by our zebra.
some newt who doesnt admire her tyrannosauruses does giggle.	quest	does some newt who doesnt admire her tyrannosauruses giggle?
the quails who your unicorns dont comfort dont accept our raven.	decl	the quails who your unicorns dont comfort dont accept our raven.
some vulture that does entertain the vultures doesnt giggle.	quest	doesnt some vulture that does entertain the vultures giggle?
my orangutans who our orangutan does confuse dont accept her newts that your newt doesnt remember.	decl	my orangutans who our orangutan does confuse dont accept her newts that your newt doesnt remember.
your quails that the orangutan doesnt applaud do move.	decl	your quails that the orangutan doesnt applaud do move.
the unicorns that my orangutans do entertain do read.	decl	the unicorns that my orangutans do entertain do read.
my quails who do remember your unicorns dont comfort the newt upon your tyrannosauruses.	quest	dont my quails who do remember your unicorns comfort the newt upon your tyrannosauruses?
the peacock does smile doesnt change.	quest	doesnt the peacock does smile change?
some vulture that your peacocks dont comfort does eat.	decl	some vulture that your peacocks dont comfort does eat.
some yak who some quails do entertain doesnt confuse her quail who does accept my walruses.	decl	some yak who some quails do entertain doesnt confuse her quail who does accept my walruses.
our peacock who does accept her peacocks doesnt smile.	decl	our peacock who does accept her peacocks doesnt smile.
her zebras who your tyrannosauruses do accept do admire your tyrannosaurus above some orangutan.	quest	do her zebras who your tyrannosauruses do accept admire your tyrannosaurus above some orangutan?
the peacock who the peacock does amuse does wait.	quest	does the peacock who the peacock does amuse wait?
her orangutans who do eat do amuse some zebras who do read.	quest	do her orangutans who do eat amuse some zebras who do read?
some peacocks that dont eat dont accept your vultures who dont entertain my raven.	quest	dont some peacocks that dont eat accept your vultures who dont entertain my raven?
the yaks who dont giggle do confuse the vulture who her tyrannosaurus doesnt high_five.	decl	the yaks who dont giggle do confuse the vulture who her tyrannosaurus doesnt high_five.
our walrus does move does sleep.	decl	our walrus does move does sleep.
some salamander that the quail does entertain doesnt eat.	quest	doesnt some salamander that the quail does entertain eat?
her zebra that does accept our newt does comfort her yak.	quest	does her zebra that does accept our newt comfort her yak?
the unicorn that my xylophones dont entertain does giggle.	decl	the unicorn that my xylophones dont entertain does giggle.
our orangutan who doesnt amuse my orangutans doesnt change.	decl	our orangutan who doesnt amuse my orangutans doesnt change.
some quails who dont read dont giggle.	decl	some quails who dont read dont giggle.
your ravens who some peacock doesnt admire dont sleep.	decl	your ravens who some peacock doesnt admire dont sleep.
your xylophone doesnt read does accept our tyrannosauruses.	quest	does your xylophone doesnt read accept our tyrannosauruses?
our yak who doesnt comfort some unicorn doesnt confuse your salamanders around her orangutan.	decl	our yak who doesnt comfort some unicorn doesnt confuse your salamanders around her orangutan.
my yak who does confuse some peacocks doesnt confuse some vulture that our peacock doesnt entertain.	quest	doesnt my yak who does confuse some peacocks confuse some vulture that our peacock doesnt entertain?
my tyrannosaurus doesnt move doesnt change.	decl	my tyrannosaurus doesnt move doesnt change.
our orangutans that the orangutan does remember dont accept the newt.	decl	our orangutans that the orangutan does remember dont accept the newt.
some peacock that does comfort her newts does remember the ravens.	decl	some peacock that does comfort her newts does remember the ravens.
our tyrannosaurus who our raven does applaud does admire your yaks behind your salamander.	quest	does our tyrannosaurus who our raven does applaud admire your yaks behind your salamander?
the peacock that some orangutans dont admire does giggle.	quest	does the peacock that some orangutans dont admire giggle?
my salamander that does applaud the tyrannosauruses doesnt swim.	decl	my salamander that does applaud the tyrannosauruses doesnt swim.
your zebras that dont smile do wait.	decl	your zebras that dont smile do wait.
the quail who does comfort her orangutan doesnt move.	decl	the quail who does comfort her orangutan doesnt move.
some peacock who my unicorns dont confuse does admire our quail who doesnt remember my xylophone.	decl	some peacock who my unicorns dont confuse does admire our quail who doesnt remember my xylophone.
our orangutans that do giggle dont move.	quest	dont our orangutans that do giggle move?
the tyrannosaurus who our peacock doesnt amuse does applaud your yaks that the salamanders dont entertain.	decl	the tyrannosaurus who our peacock doesnt amuse does applaud your yaks that the salamanders dont entertain.
some tyrannosaurus that doesnt confuse some newt doesnt read.	quest	doesnt some tyrannosaurus that doesnt confuse some newt read?
some unicorn doesnt sleep doesnt change.	quest	doesnt some unicorn doesnt sleep change?
our quails that your walrus does amuse dont entertain your xylophones.	decl	our quails that your walrus does amuse dont entertain your xylophones.
some quails that her tyrannosauruses dont admire do entertain our newt.	decl	some quails that her tyrannosauruses dont admire do entertain our newt.
the yak that my yak doesnt high_five does change.	decl	the yak that my yak doesnt high_five does change.
my tyrannosauruses that dont wait dont high_five the ravens.	decl	my tyrannosauruses that dont wait dont high_five the ravens.
the salamanders that the quail doesnt accept do change.	quest	do the salamanders that the quail doesnt accept change?
your vulture doesnt change does accept my salamander that does confuse her zebra.	quest	does your vulture doesnt change accept my salamander that does confuse her zebra?
our peacocks that some tyrannosaurus does high_five do swim.	decl	our peacocks that some tyrannosaurus does high_five do swim.
her salamanders that dont giggle dont sleep.	decl	her salamanders that dont giggle dont sleep.
some quails that do smile do comfort the ravens below some unicorn.	quest	do some quails that do smile comfort the ravens below some unicorn?
the ravens that dont accept your tyrannosauruses do giggle.	decl	the ravens that dont accept your tyrannosauruses do giggle.
the tyrannosaurus that does admire her quails doesnt giggle.	decl	the tyrannosaurus that does admire her quails doesnt giggle.
your unicorns who her salamander does applaud dont giggle.	decl	your unicorns who her salamander does applaud dont giggle.
her vulture that doesnt confuse some unicorns does entertain the orangutan that does entertain the xylophone.	quest	does her vulture that doesnt confuse some unicorns entertain the orangutan that does entertain the xylophone?
some newt that the unicorn doesnt confuse doesnt admire our raven.	quest	doesnt some newt that the unicorn doesnt confuse admire our raven?
some peacocks that do swim do smile.	quest	do some peacocks that do swim smile?
your salamanders who dont comfort your yaks do smile.	decl	your salamanders who dont comfort your yaks do smile.
our peacock that my quail does accept doesnt accept your orangutan.	decl	our peacock that my quail does accept doesnt accept your orangutan.
my tyrannosaurus doesnt sleep does comfort our newt that the peacocks dont confuse.	decl	my tyrannosaurus doesnt sleep does comfort our newt that the peacocks dont confuse.
her orangutans who dont eat do entertain my salamanders who my newt does confuse.	decl	her orangutans who dont eat do entertain my salamanders who my newt does confuse.
her salamanders who some newts dont remember do remember her ravens who do eat.	quest	do her salamanders who some newts dont remember remember her ravens who do eat?
the tyrannosauruses who dont change do comfort the orangutan.	quest	do the tyrannosauruses who dont change comfort the orangutan?
your ravens who your xylophone doesnt remember dont smile.	decl	your ravens who your xylophone doesnt remember dont smile.
our salamander that doesnt admire my orangutan does change.	quest	does our salamander that doesnt admire my orangutan change?
her xylophone who the tyrannosauruses dont admire does wait.	decl	her xylophone who the tyrannosauruses dont admire does wait.
the unicorn that the yak does high_five doesnt comfort her peacocks around some orangutans.	quest	doesnt the unicorn that the yak does high_five comfort her peacocks around some orangutans?
our salamander does move doesnt change.	quest	doesnt our salamander does move change?
your unicorns who the newts do admire do sleep.	quest	do your unicorns who the newts do admire sleep?
our salamander who her raven does remember doesnt remember our quail.	decl	our salamander who her raven does remember doesnt remember our quail.
your xylophone that her salamanders do remember does confuse the vulture.	quest	does your xylophone that her salamanders do remember confuse the vulture?
my ravens who the tyrannosauruses do high_five do smile.	decl	my ravens who the tyrannosauruses do high_five do smile.
some peacock does sleep does amuse her walrus by my newts.	decl	some peacock does sleep does amuse her walrus by my newts.
our salamanders that my vulture does entertain do sleep.	decl	our salamanders that my vulture does entertain do sleep.
her newts who do comfort your orangutans do accept your tyrannosauruses by her salamanders.	quest	do her newts who do comfort your orangutans accept your tyrannosauruses by her salamanders?
some tyrannosaurus that your orangutans do high_five doesnt comfort your newt near our yaks.	decl	some tyrannosaurus that your orangutans do high_five doesnt comfort your newt near our yaks.
her tyrannosaurus that the newts do remember does smile.	quest	does her tyrannosaurus that the newts do remember smile?
the salamanders that my quails do accept dont remember our walrus.	decl	the salamanders that my quails do accept dont remember our walrus.
some xylophones that your xylophones do high_five do smile.	quest	do some xylophones that your xylophones do high_five smile?
her unicorn who our ravens dont comfort does sleep.	quest	does her unicorn who our ravens dont comfort sleep?
my salamanders who your zebras do confuse do confuse the orangutan by some newt.	quest	do my salamanders who your zebras do confuse confuse the orangutan by some newt?
the peacock that does high_five her salamander doesnt read.	quest	doesnt the peacock that does high_five her salamander read?
some zebras who the tyrannosaurus does amuse dont change.	quest	dont some zebras who the tyrannosaurus does amuse change?
my walrus doesnt eat doesnt smile.	decl	my walrus doesnt eat doesnt smile.
the unicorn who does high_five our tyrannosauruses does comfort the tyrannosauruses behind the ravens.	decl	the unicorn who does high_five our tyrannosauruses does comfort the tyrannosauruses behind the ravens.
her zebras that dont eat dont comfort the tyrannosauruses that her peacocks do admire.	decl	her zebras that dont eat dont comfort the tyrannosauruses that her peacocks do admire.
the newt that her salamanders do entertain doesnt swim.	decl	the newt that her salamanders do entertain doesnt swim.
some newts who your walruses do remember dont swim.	decl	some newts who your walruses do remember dont swim.
her ravens who dont remember her raven dont applaud your yak below your tyrannosauruses.	decl	her ravens who dont remember her raven dont applaud your yak below your tyrannosauruses.
some peacock does move does entertain the tyrannosauruses.	quest	does some peacock does move entertain the tyrannosauruses?
her peacock that your tyrannosaurus doesnt admire doesnt wait.	decl	her peacock that your tyrannosaurus doesnt admire doesnt wait.
your peacock does eat doesnt entertain our tyrannosauruses who her salamander doesnt amuse.	decl	your peacock does eat doesnt entertain our tyrannosauruses who her salamander doesnt amuse.
her salamanders who dont change do swim.	decl	her salamanders who dont change do swim.
my vultures who your orangutans do amuse do giggle.	quest	do my vultures who your orangutans do amuse giggle?
the salamanders who dont read dont swim.	quest	dont the salamanders who dont read swim?
our walruses that dont remember our orangutans do move.	quest	do our walruses that dont remember our orangutans move?
some raven who some newts do remember doesnt giggle.	decl	some raven who some newts do remember doesnt giggle.
her tyrannosaurus doesnt read does entertain her tyrannosaurus who the unicorn does comfort.	decl	her tyrannosaurus doesnt read does entertain her tyrannosaurus who the unicorn does comfort.
her newt that some vultures do confuse doesnt read.	quest	doesnt her newt that some vultures do confuse read?
our newt who doesnt comfort the yaks does entertain my walrus.	quest	does our newt who doesnt comfort the yaks entertain my walrus?
our unicorns that our ravens do confuse dont remember the salamander below your xylophone.	quest	dont our unicorns that our ravens do confuse remember the salamander below your xylophone?
some orangutans who some salamanders dont amuse dont smile.	quest	dont some orangutans who some salamanders dont amuse smile?
the zebra who doesnt admire my peacocks does swim.	decl	the zebra who doesnt admire my peacocks does swim.
some orangutans who do smile dont admire your salamander does wait.	quest	dont some orangutans who do smile admire your salamander does wait?
your peacock who my orangutan doesnt high_five does sleep.	decl	your peacock who my orangutan doesnt high_five does sleep.
the vultures who the yak does amuse dont entertain your peacock doesnt swim.	quest	dont the vultures who the yak does amuse entertain your peacock doesnt swim?
her zebras that do comfort our salamander dont swim.	decl	her zebras that do comfort our salamander dont swim.
the orangutan does sleep doesnt smile.	decl	the orangutan does sleep doesnt smile.
the raven who does high_five her salamanders does swim.	quest	does the raven who does high_five her salamanders swim?
her vulture who your quail does remember does accept the quail that the orangutan doesnt amuse.	quest	does her vulture who your quail does remember accept the quail that the orangutan doesnt amuse?
some ravens that her quail does applaud do accept the quail upon your unicorns.	quest	do some ravens that her quail does applaud accept the quail upon your unicorns?
her newt who doesnt high_five her newt does eat.	decl	her newt who doesnt high_five her newt does eat.
my orangutan that does admire our raven does comfort our yaks above some tyrannosaurus.	quest	does my orangutan that does admire our raven comfort our yaks above some tyrannosaurus?
my quail who the unicorn does admire does accept the newt.	decl	my quail who the unicorn does admire does accept the newt.
the zebras who dont high_five my newts dont applaud our newt doesnt sleep.	decl	the zebras who dont high_five my newts dont applaud our newt doesnt sleep.
her orangutan does eat does move.	quest	does her orangutan does eat move?
her walrus who does high_five her vulture does amuse the salamander behind my vulture.	quest	does her walrus who does high_five her vulture amuse the salamander behind my vulture?
my salamander that does accept her quails does admire some xylophone by some peacock.	decl	my salamander that does accept her quails does admire some xylophone by some peacock.
her quail that doesnt accept the salamanders doesnt entertain some unicorns with my salamanders.	quest	doesnt her quail that doesnt accept the salamanders entertain some unicorns with my salamanders?
my orangutans who our walruses do comfort do confuse my raven.	decl	my orangutans who our walruses do comfort do confuse my raven.
the unicorn that the peacocks dont remember doesnt accept her orangutans who her vultures do comfort.	quest	doesnt the unicorn that the peacocks dont remember accept her orangutans who her vultures do comfort?
her raven that our orangutan does admire does giggle.	decl	her raven that our orangutan does admire does giggle.
her salamander who some newt does confuse doesnt admire our orangutans behind my walrus.	quest	doesnt her salamander who some newt does confuse admire our orangutans behind my walrus?
my salamanders who her peacocks do comfort dont eat.	quest	dont my salamanders who her peacocks do comfort eat?
her quail who your raven doesnt comfort doesnt eat.	decl	her quail who your raven doesnt comfort doesnt eat.
our vulture that doesnt accept some vulture does eat.	decl	our vulture that doesnt accept some vulture does eat.
the zebra does wait does move.	quest	does the zebra does wait move?
the ravens who dont eat do smile.	decl	the ravens who dont eat do smile.
her vultures who dont remember my orangutan do confuse my quails behind my vulture.	decl	her vultures who dont remember my orangutan do confuse my quails behind my vulture.
your yaks who do wait dont change.	quest	dont your yaks who do wait change?
your orangutan who the zebras do remember does accept my orangutan.	decl	your orangutan who the zebras do remember does accept my orangutan.
some quails that your peacocks dont admire do comfort the raven that doesnt admire her walruses.	decl	some quails that your peacocks dont admire do comfort the raven that doesnt admire her walruses.
your unicorn that doesnt admire some orangutans doesnt high_five our tyrannosaurus.	decl	your unicorn that doesnt admire some orangutans doesnt high_five our tyrannosaurus.
your quails that do swim dont entertain some raven.	quest	dont your quails that do swim entertain some raven?
our zebra that doesnt amuse her quails doesnt move.	decl	our zebra that doesnt amuse her quails doesnt move.
our vulture doesnt sleep doesnt eat.	decl	our vulture doesnt sleep doesnt eat.
some newts that my zebras dont amuse do amuse the ravens upon my yaks.	quest	do some newts that my zebras dont amuse amuse the ravens upon my yaks?
your raven that our zebra does amuse doesnt comfort the salamander who doesnt accept your walruses.	decl	your raven that our zebra does amuse doesnt comfort the salamander who doesnt accept your walruses.
your xylophone does read doesnt accept the newts.	decl	your xylophone does read doesnt accept the newts.
my quail doesnt smile does applaud some walrus.	quest	does my quail doesnt smile applaud some walrus?
your peacock doesnt swim does smile.	decl	your peacock doesnt swim does smile.
her tyrannosauruses who some unicorns dont confuse do confuse my quail who the xylophone does accept.	quest	do her tyrannosauruses who some unicorns dont confuse confuse my quail who the xylophone does accept?
some yak does read doesnt move.	quest	doesnt some yak does read move?
my quail that my walrus doesnt comfort doesnt smile.	decl	my quail that my walrus doesnt comfort doesnt smile.
her quail that doesnt applaud my vulture does confuse some vultures.	quest	does her quail that doesnt applaud my vulture confuse some vultures?
the vultures that do giggle do accept my salamander behind our salamanders.	quest	do the vultures that do giggle accept my salamander behind our salamanders?
some tyrannosauruses that the walrus does entertain dont confuse your orangutan who my quail does high_five.	decl	some tyrannosauruses that the walrus does entertain dont confuse your orangutan who my quail does high_five.
your quails who my zebras do admire dont move.	decl	your quails who my zebras do admire dont move.
my quail that some zebra does confuse doesnt swim.	decl	my quail that some zebra does confuse doesnt swim.
some salamanders who do change do admire your newt does change.	quest	do some salamanders who do change admire your newt does change?
my salamander that does entertain our quail does move.	decl	my salamander that does entertain our quail does move.
some yaks who her salamanders dont admire dont wait.	decl	some yaks who her salamanders dont admire dont wait.
our yaks that dont accept some peacocks do sleep.	decl	our yaks that dont accept some peacocks do sleep.
my quails that do comfort your orangutans do wait.	quest	do my quails that do comfort your orangutans wait?
her newt that doesnt high_five my newts does entertain some orangutans with my unicorns.	decl	her newt that doesnt high_five my newts does entertain some orangutans with my unicorns.
the tyrannosauruses that do applaud my xylophones dont comfort some ravens below my xylophone.	quest	dont the tyrannosauruses that do applaud my xylophones comfort some ravens below my xylophone?
our orangutan does eat does accept our peacock with her xylophones.	quest	does our orangutan does eat accept our peacock with her xylophones?
our orangutan who the tyrannosaurus does applaud does move.	quest	does our orangutan who the tyrannosaurus does applaud move?
our newts that my quail does entertain dont entertain my yaks that do applaud some salamander.	decl	our newts that my quail does entertain dont entertain my yaks that do applaud some salamander.
the newts who do change do giggle.	quest	do the newts who do change giggle?
her salamanders who my vultures dont accept dont change.	quest	dont her salamanders who my vultures dont accept change?
some salamander that doesnt high_five my newts does smile.	decl	some salamander that doesnt high_five my newts does smile.
the salamanders that do change do eat.	decl	the salamanders that do change do eat.
her quail doesnt swim doesnt swim.	quest	doesnt her quail doesnt swim swim?
some yak who does remember our quail doesnt giggle.	quest	doesnt some yak who does remember our quail giggle?
the newts that the salamanders dont accept do applaud your quails.	quest	do the newts that the salamanders dont accept applaud your quails?
our xylophone who doesnt comfort the orangutans doesnt sleep.	decl	our xylophone who doesnt comfort the orangutans doesnt sleep.
some tyrannosauruses who dont remember her tyrannosauruses dont move.	quest	dont some tyrannosauruses who dont remember her tyrannosauruses move?
our yaks who your newt does admire do smile.	quest	do our yaks who your newt does admire smile?
her peacock doesnt change doesnt high_five my peacocks.	quest	doesnt her peacock doesnt change high_five my peacocks?
my quail doesnt change does eat.	decl	my quail doesnt change does eat.
my orangutans who dont swim do eat.	decl	my orangutans who dont swim do eat.
her ravens who the unicorn doesnt accept dont remember the walruses above some salamander.	quest	dont her ravens who the unicorn doesnt accept remember the walruses above some salamander?
her vultures that your peacock does amuse dont confuse your xylophones.	quest	dont her vultures that your peacock does amuse confuse your xylophones?
the ravens that dont wait dont read.	quest	dont the ravens that dont wait read?
the tyrannosaurus doesnt move doesnt eat.	quest	doesnt the tyrannosaurus doesnt move eat?
some ravens that your peacocks do comfort dont giggle.	decl	some ravens that your peacocks do comfort dont giggle.
our xylophones who your vulture does comfort dont accept some unicorn that doesnt confuse her zebras.	decl	our xylophones who your vulture does comfort dont accept some unicorn that doesnt confuse her zebras.
the orangutans that dont applaud the xylophones dont sleep.	decl	the orangutans that dont applaud the xylophones dont sleep.
our unicorns that dont comfort my peacocks do giggle.	quest	do our unicorns that dont comfort my peacocks giggle?
some quail does change doesnt remember our vultures that our vulture doesnt high_five.	quest	doesnt some quail does change remember our vultures that our vulture doesnt high_five?
the raven does wait does change.	quest	does the raven does wait change?
your salamanders who my newts do high_five dont high_five some unicorns.	decl	your salamanders who my newts do high_five dont high_five some unicorns.
your zebra doesnt eat does remember your unicorns behind some yak.	decl	your zebra doesnt eat does remember your unicorns behind some yak.
some quails that your quails dont accept dont change.	quest	dont some quails that your quails dont accept change?
our ravens who our tyrannosauruses do high_five dont move.	quest	dont our ravens who our tyrannosauruses do high_five move?
our vulture doesnt giggle does confuse the vultures around my quail.	decl	our vulture doesnt giggle does confuse the vultures around my quail.
her quail that doesnt admire my orangutans doesnt wait.	decl	her quail that doesnt admire my orangutans doesnt wait.
your tyrannosaurus does read doesnt giggle.	quest	doesnt your tyrannosaurus does read giggle?
my salamanders that your orangutans dont comfort dont smile.	quest	dont my salamanders that your orangutans dont comfort smile?
our tyrannosauruses who the newt doesnt amuse dont move.	quest	dont our tyrannosauruses who the newt doesnt amuse move?
her orangutans that do entertain our newts do confuse our raven.	decl	her orangutans that do entertain our newts do confuse our raven.
her quail who does accept her quail doesnt smile.	decl	her quail who does accept her quail doesnt smile.
our quails who my peacock doesnt amuse do sleep.	quest	do our quails who my peacock doesnt amuse sleep?
her peacocks who do confuse my ravens dont entertain some xylophone that does entertain her peacocks.	quest	dont her peacocks who do confuse my ravens entertain some xylophone that does entertain her peacocks?
my salamander that our salamander doesnt applaud does comfort some ravens.	decl	my salamander that our salamander doesnt applaud does comfort some ravens.
my newt does wait does admire your orangutan.	decl	my newt does wait does admire your orangutan.
her salamanders that some salamanders do remember dont smile.	quest	dont her salamanders that some salamanders do remember smile?
her quails that do move do swim.	quest	do her quails that do move swim?
my orangutan who doesnt remember the orangutans doesnt comfort your tyrannosauruses upon her tyrannosaurus.	decl	my orangutan who doesnt remember the orangutans doesnt comfort your tyrannosauruses upon her tyrannosaurus.
her xylophone that does admire your newt doesnt high_five my ravens with the salamanders.	decl	her xylophone that does admire your newt doesnt high_five my ravens with the salamanders.
her newts who do entertain the newt do remember her xylophones behind our tyrannosauruses.	decl	her newts who do entertain the newt do remember her xylophones behind our tyrannosauruses.
your newt does swim does read.	decl	your newt does swim does read.
her unicorn that your salamander doesnt entertain does entertain your zebra who her raven doesnt high_five.	decl	her unicorn that your salamander doesnt entertain does entertain your zebra who her raven doesnt high_five.
some salamanders that the orangutan doesnt accept do applaud our quail upon the vulture.	decl	some salamanders that the orangutan doesnt accept do applaud our quail upon the vulture.
your unicorns that the newt doesnt entertain do accept my tyrannosaurus doesnt read.	quest	do your unicorns that the newt doesnt entertain accept my tyrannosaurus doesnt read?
your salamanders that our tyrannosaurus does accept do change.	quest	do your salamanders that our tyrannosaurus does accept change?
our unicorn who doesnt high_five your orangutans doesnt swim.	decl	our unicorn who doesnt high_five your orangutans doesnt swim.
some orangutan who our peacock does comfort doesnt wait.	decl	some orangutan who our peacock does comfort doesnt wait.
the unicorn who the tyrannosaurus does entertain doesnt swim.	quest	doesnt the unicorn who the tyrannosaurus does entertain swim?
her quails who the salamander does accept do move.	decl	her quails who the salamander does accept do move.
her walrus who doesnt remember your quails doesnt entertain the tyrannosaurus.	quest	doesnt her walrus who doesnt remember your quails entertain the tyrannosaurus?
her raven that doesnt high_five some zebras does applaud our unicorns above your tyrannosauruses.	decl	her raven that doesnt high_five some zebras does applaud our unicorns above your tyrannosauruses.
the xylophone who doesnt applaud some orangutans does move.	quest	does the xylophone who doesnt applaud some orangutans move?
my peacock doesnt read doesnt eat.	decl	my peacock doesnt read doesnt eat.
some orangutan that our walrus doesnt entertain does comfort my peacock does smile.	decl	some orangutan that our walrus doesnt entertain does comfort my peacock does smile.
your orangutan does eat doesnt read.	decl	your orangutan does eat doesnt read.
some peacock that some raven doesnt remember does confuse our newt near some salamanders.	quest	does some peacock that some raven doesnt remember confuse our newt near some salamanders?
the raven doesnt giggle does sleep.	decl	the raven doesnt giggle does sleep.
her vulture who does accept the orangutan does high_five the newt upon her raven.	decl	her vulture who does accept the orangutan does high_five the newt upon her raven.
the vulture who our salamander does entertain doesnt swim.	quest	doesnt the vulture who our salamander does entertain swim?
our newts who do wait do smile.	quest	do our newts who do wait smile?
the vultures that your orangutans do confuse do change.	quest	do the vultures that your orangutans do confuse change?
her newt that the newt doesnt high_five does applaud your xylophone does move.	decl	her newt that the newt doesnt high_five does applaud your xylophone does move.
your salamanders who do eat dont confuse the salamanders who do sleep.	quest	dont your salamanders who do eat confuse the salamanders who do sleep?
my ravens that dont accept your salamander do change.	decl	my ravens that dont accept your salamander do change.
some quails that some ravens dont entertain do sleep.	decl	some quails that some ravens dont entertain do sleep.
some orangutan doesnt wait doesnt read.	quest	doesnt some orangutan doesnt wait read?
your tyrannosauruses who do entertain our tyrannosauruses do comfort my walrus below the orangutan.	quest	do your tyrannosauruses who do entertain our tyrannosauruses comfort my walrus below the orangutan?
the salamanders that the peacock does applaud do amuse my zebra who some orangutan doesnt confuse.	decl	the salamanders that the peacock does applaud do amuse my zebra who some orangutan doesnt confuse.
