source	target	prediction
eliza slumbers <eos>	slumber ( eliza ) <eos>	slumber ( eliza ) <eos>
rachael sings <eos>	sing ( rachael ) <eos>	sing ( rachael ) <eos>
zelda flies <eos>	fly ( zelda ) <eos>	fly ( zelda ) <eos>
bob sings <eos>	sing ( bob ) <eos>	sing ( bob ) <eos>
alice sleeps <eos>	sleep ( alice ) <eos>	sleep ( alice ) <eos>
katherine meets henry <eos>	meet ( katherine , henry ) <eos>	meet ( katherine , henry ) <eos>
tracy throws isla <eos>	throw ( tracy , isla ) <eos>	throw ( tracy , isla ) <eos>
xerxes sleeps <eos>	sleep ( xerxes ) <eos>	sleep ( xerxes ) <eos>
tracy runs <eos>	run ( tracy ) <eos>	run ( tracy ) <eos>
margaret walks <eos>	walk ( margaret ) <eos>	walk ( margaret ) <eos>
neha sees ursula <eos>	see ( neha , ursula ) <eos>	see ( neha , ursula ) <eos>
bob likes lewis <eos>	like ( bob , lewis ) <eos>	like ( bob , lewis ) <eos>
katherine knows zelda <eos>	know ( katherine , zelda ) <eos>	know ( katherine , zelda ) <eos>
patricia throws john <eos>	throw ( patricia , john ) <eos>	throw ( patricia , john ) <eos>
yvette knows tracy <eos>	know ( yvettte , tracy ) <eos>	know ( yvettte , tracy ) <eos>
margaret knows katherine <eos>	know ( margaret , katherine ) <eos>	know ( margaret , katherine ) <eos>
rachael sees neha <eos>	see ( rachael , neha ) <eos>	see ( rachael , neha ) <eos>
alice knows herself <eos>	know ( alice , alice ) <eos>	know ( alice , alice ) <eos>
yvette dislikes grace <eos>	dislike ( yvettte , grace ) <eos>	dislike ( yvettte , grace ) <eos>
grace sees alice <eos>	see ( grace , alice ) <eos>	see ( grace , alice ) <eos>
winnifred meets daniel <eos>	meet ( winnifred , daniel ) <eos>	meet ( winnifred , daniel ) <eos>
winnifred meets john <eos>	meet ( winnifred , john ) <eos>	meet ( winnifred , john ) <eos>
daniel throws eliza <eos>	throw ( daniel , eliza ) <eos>	throw ( daniel , eliza ) <eos>
oswald throws oswald <eos>	throw ( oswald , oswald ) <eos>	throw ( oswald , oswald ) <eos>
katherine throws winnifred <eos>	throw ( katherine , winnifred ) <eos>	throw ( katherine , winnifred ) <eos>
alice meets quinn <eos>	meet ( alice , quinn ) <eos>	meet ( alice , quinn ) <eos>
eliza meets bob <eos>	meet ( eliza , bob ) <eos>	meet ( eliza , bob ) <eos>
claire sees quinn <eos>	see ( claire , quinn ) <eos>	see ( claire , quinn ) <eos>
winnifred sees isla <eos>	see ( winnifred , isla ) <eos>	see ( winnifred , isla ) <eos>
eliza throws xerxes <eos>	throw ( eliza , xerxes ) <eos>	throw ( eliza , xerxes ) <eos>
victor dislikes henry <eos>	dislike ( victor , henry ) <eos>	dislike ( victor , henry ) <eos>
winnifred throws zelda <eos>	throw ( winnifred , zelda ) <eos>	throw ( winnifred , zelda ) <eos>
alice notices winnifred <eos>	notice ( alice , winnifred ) <eos>	notice ( alice , winnifred ) <eos>
bob notices lewis <eos>	notice ( bob , lewis ) <eos>	notice ( bob , lewis ) <eos>
isla dislikes lewis <eos>	dislike ( isla , lewis ) <eos>	dislike ( isla , lewis ) <eos>
xerxes dislikes eliza <eos>	dislike ( xerxes , eliza ) <eos>	dislike ( xerxes , eliza ) <eos>
victor throws claire <eos>	throw ( victor , claire ) <eos>	throw ( victor , claire ) <eos>
henry throws patricia <eos>	throw ( henry , patricia ) <eos>	throw ( henry , patricia ) <eos>
lewis throws himself <eos>	throw ( lewis , lewis ) <eos>	throw ( lewis , lewis ) <eos>
tracy dislikes rachael <eos>	dislike ( tracy , rachael ) <eos>	dislike ( tracy , rachael ) <eos>
neha throws victor <eos>	throw ( neha , victor ) <eos>	throw ( neha , victor ) <eos>
victor knows patricia <eos>	know ( victor , patricia ) <eos>	know ( victor , patricia ) <eos>
margaret meets yvette <eos>	meet ( margaret , yvettte ) <eos>	meet ( margaret , yvettte ) <eos>
lewis throws victor <eos>	throw ( lewis , victor ) <eos>	throw ( lewis , victor ) <eos>
grace throws oswald <eos>	throw ( grace , oswald ) <eos>	throw ( grace , oswald ) <eos>
isla sleeps <eos>	sleep ( isla ) <eos>	sleep ( isla ) <eos>
patricia dances <eos>	dance ( patricia ) <eos>	dance ( patricia ) <eos>
margaret eats <eos>	eat ( margaret ) <eos>	eat ( margaret ) <eos>
yvette eats <eos>	eat ( yvettte ) <eos>	eat ( yvettte ) <eos>
margaret runs <eos>	run ( margaret ) <eos>	run ( margaret ) <eos>
francis notices francis <eos>	notice ( francis , francis ) <eos>	notice ( francis , francis ) <eos>
samuel knows eliza <eos>	know ( samuel , eliza ) <eos>	know ( samuel , eliza ) <eos>
samuel sees claire <eos>	see ( samuel , claire ) <eos>	see ( samuel , claire ) <eos>
alice meets daniel <eos>	meet ( alice , daniel ) <eos>	meet ( alice , daniel ) <eos>
lewis notices zelda <eos>	notice ( lewis , zelda ) <eos>	notice ( lewis , zelda ) <eos>
margaret likes katherine <eos>	like ( margaret , katherine ) <eos>	like ( margaret , katherine ) <eos>
neha notices john <eos>	notice ( neha , john ) <eos>	notice ( neha , john ) <eos>
eliza meets daniel <eos>	meet ( eliza , daniel ) <eos>	meet ( eliza , daniel ) <eos>
neha knows claire <eos>	know ( neha , claire ) <eos>	know ( neha , claire ) <eos>
alice knows katherine <eos>	know ( alice , katherine ) <eos>	know ( alice , katherine ) <eos>
patricia likes rachael <eos>	like ( patricia , rachael ) <eos>	like ( patricia , rachael ) <eos>
winnifred knows bob <eos>	know ( winnifred , bob ) <eos>	know ( winnifred , bob ) <eos>
isla dislikes john <eos>	dislike ( isla , john ) <eos>	dislike ( isla , john ) <eos>
oswald likes tracy <eos>	like ( oswald , tracy ) <eos>	like ( oswald , tracy ) <eos>
henry knows yvette <eos>	know ( henry , yvettte ) <eos>	know ( henry , yvettte ) <eos>
winnifred likes bob <eos>	like ( winnifred , bob ) <eos>	like ( winnifred , bob ) <eos>
eliza knows katherine <eos>	know ( eliza , katherine ) <eos>	know ( eliza , katherine ) <eos>
rachael likes grace <eos>	like ( rachael , grace ) <eos>	like ( rachael , grace ) <eos>
katherine notices ursula <eos>	notice ( katherine , ursula ) <eos>	notice ( katherine , ursula ) <eos>
zelda likes quinn <eos>	like ( zelda , quinn ) <eos>	like ( zelda , quinn ) <eos>
neha dislikes herself <eos>	dislike ( neha , neha ) <eos>	dislike ( neha , neha ) <eos>
alice likes claire <eos>	like ( alice , claire ) <eos>	like ( alice , claire ) <eos>
grace knows isla <eos>	know ( grace , isla ) <eos>	know ( grace , isla ) <eos>
patricia likes margaret <eos>	like ( patricia , margaret ) <eos>	like ( patricia , margaret ) <eos>
katherine meets grace <eos>	meet ( katherine , grace ) <eos>	meet ( katherine , grace ) <eos>
alice meets samuel <eos>	meet ( alice , samuel ) <eos>	meet ( alice , samuel ) <eos>
yvette throws xerxes <eos>	throw ( yvettte , xerxes ) <eos>	throw ( yvettte , xerxes ) <eos>
isla likes claire <eos>	like ( isla , claire ) <eos>	like ( isla , claire ) <eos>
zelda likes eliza <eos>	like ( zelda , eliza ) <eos>	like ( zelda , eliza ) <eos>
victor notices isla <eos>	notice ( victor , isla ) <eos>	notice ( victor , isla ) <eos>
alice sees lewis <eos>	see ( alice , lewis ) <eos>	see ( alice , lewis ) <eos>
bob sees eliza <eos>	see ( bob , eliza ) <eos>	see ( bob , eliza ) <eos>
neha throws samuel <eos>	throw ( neha , samuel ) <eos>	throw ( neha , samuel ) <eos>
ursula knows samuel <eos>	know ( ursula , samuel ) <eos>	know ( ursula , samuel ) <eos>
yvette dislikes lewis <eos>	dislike ( yvettte , lewis ) <eos>	dislike ( yvettte , lewis ) <eos>
neha throws xerxes <eos>	throw ( neha , xerxes ) <eos>	throw ( neha , xerxes ) <eos>
john throws grace <eos>	throw ( john , grace ) <eos>	throw ( john , grace ) <eos>
eliza sees lewis <eos>	see ( eliza , lewis ) <eos>	see ( eliza , lewis ) <eos>
bob likes himself <eos>	like ( bob , bob ) <eos>	like ( bob , bob ) <eos>
alice notices zelda <eos>	notice ( alice , zelda ) <eos>	notice ( alice , zelda ) <eos>
john sees eliza <eos>	see ( john , eliza ) <eos>	see ( john , eliza ) <eos>
isla throws tracy <eos>	throw ( isla , tracy ) <eos>	throw ( isla , tracy ) <eos>
xerxes notices katherine <eos>	notice ( xerxes , katherine ) <eos>	notice ( xerxes , katherine ) <eos>
winnifred likes quinn <eos>	like ( winnifred , quinn ) <eos>	like ( winnifred , quinn ) <eos>
katherine notices patricia <eos>	notice ( katherine , patricia ) <eos>	notice ( katherine , patricia ) <eos>
victor dislikes himself <eos>	dislike ( victor , victor ) <eos>	dislike ( victor , victor ) <eos>
francis meets lewis <eos>	meet ( francis , lewis ) <eos>	meet ( francis , lewis ) <eos>
neha notices quinn <eos>	notice ( neha , quinn ) <eos>	notice ( neha , quinn ) <eos>
henry throws winnifred <eos>	throw ( henry , winnifred ) <eos>	throw ( henry , winnifred ) <eos>
samuel knows himself <eos>	know ( samuel , samuel ) <eos>	know ( samuel , samuel ) <eos>
ursula throws rachael <eos>	throw ( ursula , rachael ) <eos>	throw ( ursula , rachael ) <eos>
tracy sees alice <eos>	see ( tracy , alice ) <eos>	see ( tracy , alice ) <eos>
john meets henry <eos>	meet ( john , henry ) <eos>	meet ( john , henry ) <eos>
grace meets eliza <eos>	meet ( grace , eliza ) <eos>	meet ( grace , eliza ) <eos>
neha meets yvette <eos>	meet ( neha , yvettte ) <eos>	meet ( neha , yvettte ) <eos>
zelda knows herself <eos>	know ( zelda , zelda ) <eos>	know ( zelda , zelda ) <eos>
neha sees margaret <eos>	see ( neha , margaret ) <eos>	see ( neha , margaret ) <eos>
zelda throws john <eos>	throw ( zelda , john ) <eos>	throw ( zelda , john ) <eos>
bob meets eliza <eos>	meet ( bob , eliza ) <eos>	meet ( bob , eliza ) <eos>
alice sees yvette <eos>	see ( alice , yvettte ) <eos>	see ( alice , yvettte ) <eos>
francis likes tracy <eos>	like ( francis , tracy ) <eos>	like ( francis , tracy ) <eos>
bob dislikes yvette <eos>	dislike ( bob , yvettte ) <eos>	dislike ( bob , yvettte ) <eos>
patricia throws francis <eos>	throw ( patricia , francis ) <eos>	throw ( patricia , francis ) <eos>
zelda notices grace <eos>	notice ( zelda , grace ) <eos>	notice ( zelda , grace ) <eos>
francis likes margaret <eos>	like ( francis , margaret ) <eos>	like ( francis , margaret ) <eos>
john dislikes daniel <eos>	dislike ( john , daniel ) <eos>	dislike ( john , daniel ) <eos>
francis knows eliza <eos>	know ( francis , eliza ) <eos>	know ( francis , eliza ) <eos>
neha sees patricia <eos>	see ( neha , patricia ) <eos>	see ( neha , patricia ) <eos>
isla likes bob <eos>	like ( isla , bob ) <eos>	like ( isla , bob ) <eos>
daniel knows ursula <eos>	know ( daniel , ursula ) <eos>	know ( daniel , ursula ) <eos>
henry dislikes eliza <eos>	dislike ( henry , eliza ) <eos>	dislike ( henry , eliza ) <eos>
winnifred dislikes xerxes <eos>	dislike ( winnifred , xerxes ) <eos>	dislike ( winnifred , xerxes ) <eos>
eliza throws john <eos>	throw ( eliza , john ) <eos>	throw ( eliza , john ) <eos>
margaret knows daniel <eos>	know ( margaret , daniel ) <eos>	know ( margaret , daniel ) <eos>
rachael throws john <eos>	throw ( rachael , john ) <eos>	throw ( rachael , john ) <eos>
winnifred likes daniel <eos>	like ( winnifred , daniel ) <eos>	like ( winnifred , daniel ) <eos>
oswald sees quinn <eos>	see ( oswald , quinn ) <eos>	see ( oswald , quinn ) <eos>
claire knows grace <eos>	know ( claire , grace ) <eos>	know ( claire , grace ) <eos>
xerxes throws margaret <eos>	throw ( xerxes , margaret ) <eos>	throw ( xerxes , margaret ) <eos>
lewis dislikes francis <eos>	dislike ( lewis , francis ) <eos>	dislike ( lewis , francis ) <eos>
samuel sees bob <eos>	see ( samuel , bob ) <eos>	see ( samuel , bob ) <eos>
victor likes isla <eos>	like ( victor , isla ) <eos>	like ( victor , isla ) <eos>
yvette likes katherine <eos>	like ( yvettte , katherine ) <eos>	like ( yvettte , katherine ) <eos>
quinn notices oswald <eos>	notice ( quinn , oswald ) <eos>	notice ( quinn , oswald ) <eos>
quinn notices claire <eos>	notice ( quinn , claire ) <eos>	notice ( quinn , claire ) <eos>
grace likes patricia <eos>	like ( grace , patricia ) <eos>	like ( grace , patricia ) <eos>
bob throws samuel <eos>	throw ( bob , samuel ) <eos>	throw ( bob , samuel ) <eos>
zelda likes henry <eos>	like ( zelda , henry ) <eos>	like ( zelda , henry ) <eos>
rachael sees grace <eos>	see ( rachael , grace ) <eos>	see ( rachael , grace ) <eos>
ursula dislikes rachael <eos>	dislike ( ursula , rachael ) <eos>	dislike ( ursula , rachael ) <eos>
margaret likes alice <eos>	like ( margaret , alice ) <eos>	like ( margaret , alice ) <eos>
daniel dislikes grace <eos>	dislike ( daniel , grace ) <eos>	dislike ( daniel , grace ) <eos>
neha throws katherine <eos>	throw ( neha , katherine ) <eos>	throw ( neha , katherine ) <eos>
zelda throws henry <eos>	throw ( zelda , henry ) <eos>	throw ( zelda , henry ) <eos>
yvette notices bob <eos>	notice ( yvettte , bob ) <eos>	notice ( yvettte , bob ) <eos>
victor notices katherine <eos>	notice ( victor , katherine ) <eos>	notice ( victor , katherine ) <eos>
isla meets patricia <eos>	meet ( isla , patricia ) <eos>	meet ( isla , patricia ) <eos>
bob meets victor <eos>	meet ( bob , victor ) <eos>	meet ( bob , victor ) <eos>
isla throws patricia <eos>	throw ( isla , patricia ) <eos>	throw ( isla , patricia ) <eos>
margaret sees bob <eos>	see ( margaret , bob ) <eos>	see ( margaret , bob ) <eos>
samuel likes lewis <eos>	like ( samuel , lewis ) <eos>	like ( samuel , lewis ) <eos>
rachael throws samuel <eos>	throw ( rachael , samuel ) <eos>	throw ( rachael , samuel ) <eos>
alice dislikes herself <eos>	dislike ( alice , alice ) <eos>	dislike ( alice , alice ) <eos>
grace meets victor <eos>	meet ( grace , victor ) <eos>	meet ( grace , victor ) <eos>
john dislikes neha <eos>	dislike ( john , neha ) <eos>	dislike ( john , neha ) <eos>
xerxes notices ursula <eos>	notice ( xerxes , ursula ) <eos>	notice ( xerxes , ursula ) <eos>
ursula likes alice <eos>	like ( ursula , alice ) <eos>	like ( ursula , alice ) <eos>
tracy meets zelda <eos>	meet ( tracy , zelda ) <eos>	meet ( tracy , zelda ) <eos>
xerxes likes daniel <eos>	like ( xerxes , daniel ) <eos>	like ( xerxes , daniel ) <eos>
alice knows daniel <eos>	know ( alice , daniel ) <eos>	know ( alice , daniel ) <eos>
daniel meets daniel <eos>	meet ( daniel , daniel ) <eos>	meet ( daniel , daniel ) <eos>
oswald knows yvette <eos>	know ( oswald , yvettte ) <eos>	know ( oswald , yvettte ) <eos>
eliza sees ursula <eos>	see ( eliza , ursula ) <eos>	see ( eliza , ursula ) <eos>
xerxes dislikes rachael <eos>	dislike ( xerxes , rachael ) <eos>	dislike ( xerxes , rachael ) <eos>
alice sees ursula <eos>	see ( alice , ursula ) <eos>	see ( alice , ursula ) <eos>
alice knows isla <eos>	know ( alice , isla ) <eos>	know ( alice , isla ) <eos>
neha likes margaret <eos>	like ( neha , margaret ) <eos>	like ( neha , margaret ) <eos>
margaret dislikes margaret <eos>	dislike ( margaret , margaret ) <eos>	dislike ( margaret , margaret ) <eos>
francis likes yvette <eos>	like ( francis , yvettte ) <eos>	like ( francis , yvettte ) <eos>
grace likes winnifred <eos>	like ( grace , winnifred ) <eos>	like ( grace , winnifred ) <eos>
alice throws herself <eos>	throw ( alice , alice ) <eos>	throw ( alice , alice ) <eos>
zelda knows margaret <eos>	know ( zelda , margaret ) <eos>	know ( zelda , margaret ) <eos>
victor notices xerxes <eos>	notice ( victor , xerxes ) <eos>	notice ( victor , xerxes ) <eos>
xerxes sees rachael <eos>	see ( xerxes , rachael ) <eos>	see ( xerxes , rachael ) <eos>
katherine likes alice <eos>	like ( katherine , alice ) <eos>	like ( katherine , alice ) <eos>
henry dislikes oswald <eos>	dislike ( henry , oswald ) <eos>	dislike ( henry , oswald ) <eos>
zelda throws samuel <eos>	throw ( zelda , samuel ) <eos>	throw ( zelda , samuel ) <eos>
daniel meets rachael <eos>	meet ( daniel , rachael ) <eos>	meet ( daniel , rachael ) <eos>
rachael likes yvette <eos>	like ( rachael , yvettte ) <eos>	like ( rachael , yvettte ) <eos>
alice meets john <eos>	meet ( alice , john ) <eos>	meet ( alice , john ) <eos>
lewis throws lewis <eos>	throw ( lewis , lewis ) <eos>	throw ( lewis , lewis ) <eos>
samuel throws margaret <eos>	throw ( samuel , margaret ) <eos>	throw ( samuel , margaret ) <eos>
grace sees oswald <eos>	see ( grace , oswald ) <eos>	see ( grace , oswald ) <eos>
oswald dislikes grace <eos>	dislike ( oswald , grace ) <eos>	dislike ( oswald , grace ) <eos>
oswald knows grace <eos>	know ( oswald , grace ) <eos>	know ( oswald , grace ) <eos>
quinn sees francis <eos>	see ( quinn , francis ) <eos>	see ( quinn , francis ) <eos>
john notices bob <eos>	notice ( john , bob ) <eos>	notice ( john , bob ) <eos>
francis throws rachael <eos>	throw ( francis , rachael ) <eos>	throw ( francis , rachael ) <eos>
lewis sees victor <eos>	see ( lewis , victor ) <eos>	see ( lewis , victor ) <eos>
zelda throws oswald <eos>	throw ( zelda , oswald ) <eos>	throw ( zelda , oswald ) <eos>
claire meets katherine <eos>	meet ( claire , katherine ) <eos>	meet ( claire , katherine ) <eos>
isla knows ursula <eos>	know ( isla , ursula ) <eos>	know ( isla , ursula ) <eos>
neha notices henry <eos>	notice ( neha , henry ) <eos>	notice ( neha , henry ) <eos>
winnifred likes patricia <eos>	like ( winnifred , patricia ) <eos>	like ( winnifred , patricia ) <eos>
yvette notices yvette <eos>	notice ( yvettte , yvettte ) <eos>	notice ( yvettte , yvettte ) <eos>
grace sees patricia <eos>	see ( grace , patricia ) <eos>	see ( grace , patricia ) <eos>
eliza throws victor <eos>	throw ( eliza , victor ) <eos>	throw ( eliza , victor ) <eos>
tracy notices victor <eos>	notice ( tracy , victor ) <eos>	notice ( tracy , victor ) <eos>
patricia throws margaret <eos>	throw ( patricia , margaret ) <eos>	throw ( patricia , margaret ) <eos>
eliza knows xerxes <eos>	know ( eliza , xerxes ) <eos>	know ( eliza , xerxes ) <eos>
katherine notices tracy <eos>	notice ( katherine , tracy ) <eos>	notice ( katherine , tracy ) <eos>
yvette sees xerxes <eos>	see ( yvettte , xerxes ) <eos>	see ( yvettte , xerxes ) <eos>
xerxes meets katherine <eos>	meet ( xerxes , katherine ) <eos>	meet ( xerxes , katherine ) <eos>
lewis knows katherine <eos>	know ( lewis , katherine ) <eos>	know ( lewis , katherine ) <eos>
quinn likes tracy <eos>	like ( quinn , tracy ) <eos>	like ( quinn , tracy ) <eos>
katherine knows eliza <eos>	know ( katherine , eliza ) <eos>	know ( katherine , eliza ) <eos>
claire likes john <eos>	like ( claire , john ) <eos>	like ( claire , john ) <eos>
eliza throws ursula <eos>	throw ( eliza , ursula ) <eos>	throw ( eliza , ursula ) <eos>
zelda meets katherine <eos>	meet ( zelda , katherine ) <eos>	meet ( zelda , katherine ) <eos>
john throws samuel <eos>	throw ( john , samuel ) <eos>	throw ( john , samuel ) <eos>
margaret throws grace <eos>	throw ( margaret , grace ) <eos>	throw ( margaret , grace ) <eos>
alice notices ursula <eos>	notice ( alice , ursula ) <eos>	notice ( alice , ursula ) <eos>
daniel sees tracy <eos>	see ( daniel , tracy ) <eos>	see ( daniel , tracy ) <eos>
winnifred sees oswald <eos>	see ( winnifred , oswald ) <eos>	see ( winnifred , oswald ) <eos>
francis dislikes xerxes <eos>	dislike ( francis , xerxes ) <eos>	dislike ( francis , xerxes ) <eos>
grace knows katherine <eos>	know ( grace , katherine ) <eos>	know ( grace , katherine ) <eos>
samuel meets rachael <eos>	meet ( samuel , rachael ) <eos>	meet ( samuel , rachael ) <eos>
victor sees neha <eos>	see ( victor , neha ) <eos>	see ( victor , neha ) <eos>
victor notices victor <eos>	notice ( victor , victor ) <eos>	notice ( victor , victor ) <eos>
john meets tracy <eos>	meet ( john , tracy ) <eos>	meet ( john , tracy ) <eos>
ursula sees francis <eos>	see ( ursula , francis ) <eos>	see ( ursula , francis ) <eos>
francis throws victor <eos>	throw ( francis , victor ) <eos>	throw ( francis , victor ) <eos>
tracy dislikes ursula <eos>	dislike ( tracy , ursula ) <eos>	dislike ( tracy , ursula ) <eos>
zelda dislikes patricia <eos>	dislike ( zelda , patricia ) <eos>	dislike ( zelda , patricia ) <eos>
francis sees rachael <eos>	see ( francis , rachael ) <eos>	see ( francis , rachael ) <eos>
xerxes dislikes lewis <eos>	dislike ( xerxes , lewis ) <eos>	dislike ( xerxes , lewis ) <eos>
katherine sees ursula <eos>	see ( katherine , ursula ) <eos>	see ( katherine , ursula ) <eos>
claire dislikes lewis <eos>	dislike ( claire , lewis ) <eos>	dislike ( claire , lewis ) <eos>
zelda dislikes xerxes <eos>	dislike ( zelda , xerxes ) <eos>	dislike ( zelda , xerxes ) <eos>
claire meets neha <eos>	meet ( claire , neha ) <eos>	meet ( claire , neha ) <eos>
alice meets herself <eos>	meet ( alice , alice ) <eos>	meet ( alice , alice ) <eos>
samuel dislikes zelda <eos>	dislike ( samuel , zelda ) <eos>	dislike ( samuel , zelda ) <eos>
oswald knows winnifred <eos>	know ( oswald , winnifred ) <eos>	know ( oswald , winnifred ) <eos>
francis knows quinn <eos>	know ( francis , quinn ) <eos>	know ( francis , quinn ) <eos>
oswald knows bob <eos>	know ( oswald , bob ) <eos>	know ( oswald , bob ) <eos>
lewis notices margaret <eos>	notice ( lewis , margaret ) <eos>	notice ( lewis , margaret ) <eos>
isla notices oswald <eos>	notice ( isla , oswald ) <eos>	notice ( isla , oswald ) <eos>
quinn meets yvette <eos>	meet ( quinn , yvettte ) <eos>	meet ( quinn , yvettte ) <eos>
bob throws neha <eos>	throw ( bob , neha ) <eos>	throw ( bob , neha ) <eos>
victor meets yvette <eos>	meet ( victor , yvettte ) <eos>	meet ( victor , yvettte ) <eos>
bob knows victor <eos>	know ( bob , victor ) <eos>	know ( bob , victor ) <eos>
patricia notices bob <eos>	notice ( patricia , bob ) <eos>	notice ( patricia , bob ) <eos>
margaret sees rachael <eos>	see ( margaret , rachael ) <eos>	see ( margaret , rachael ) <eos>
katherine dislikes zelda <eos>	dislike ( katherine , zelda ) <eos>	dislike ( katherine , zelda ) <eos>
lewis sees samuel <eos>	see ( lewis , samuel ) <eos>	see ( lewis , samuel ) <eos>
daniel dislikes yvette <eos>	dislike ( daniel , yvettte ) <eos>	dislike ( daniel , yvettte ) <eos>
samuel dislikes neha <eos>	dislike ( samuel , neha ) <eos>	dislike ( samuel , neha ) <eos>
bob sees lewis <eos>	see ( bob , lewis ) <eos>	see ( bob , lewis ) <eos>
neha notices yvette <eos>	notice ( neha , yvettte ) <eos>	notice ( neha , yvettte ) <eos>
katherine sees daniel <eos>	see ( katherine , daniel ) <eos>	see ( katherine , daniel ) <eos>
margaret throws yvette <eos>	throw ( margaret , yvettte ) <eos>	throw ( margaret , yvettte ) <eos>
xerxes likes neha <eos>	like ( xerxes , neha ) <eos>	like ( xerxes , neha ) <eos>
margaret sees ursula <eos>	see ( margaret , ursula ) <eos>	see ( margaret , ursula ) <eos>
tracy throws bob <eos>	throw ( tracy , bob ) <eos>	throw ( tracy , bob ) <eos>
bob meets john <eos>	meet ( bob , john ) <eos>	meet ( bob , john ) <eos>
yvette knows claire <eos>	know ( yvettte , claire ) <eos>	know ( yvettte , claire ) <eos>
john notices francis <eos>	notice ( john , francis ) <eos>	notice ( john , francis ) <eos>
winnifred notices victor <eos>	notice ( winnifred , victor ) <eos>	notice ( winnifred , victor ) <eos>
john notices margaret <eos>	notice ( john , margaret ) <eos>	notice ( john , margaret ) <eos>
quinn sees alice <eos>	see ( quinn , alice ) <eos>	see ( quinn , alice ) <eos>
yvette meets herself <eos>	meet ( yvettte , yvettte ) <eos>	meet ( yvettte , yvettte ) <eos>
samuel notices oswald <eos>	notice ( samuel , oswald ) <eos>	notice ( samuel , oswald ) <eos>
winnifred notices alice <eos>	notice ( winnifred , alice ) <eos>	notice ( winnifred , alice ) <eos>
rachael dislikes daniel <eos>	dislike ( rachael , daniel ) <eos>	dislike ( rachael , daniel ) <eos>
eliza notices francis <eos>	notice ( eliza , francis ) <eos>	notice ( eliza , francis ) <eos>
grace knows neha <eos>	know ( grace , neha ) <eos>	know ( grace , neha ) <eos>
margaret meets winnifred <eos>	meet ( margaret , winnifred ) <eos>	meet ( margaret , winnifred ) <eos>
isla dislikes eliza <eos>	dislike ( isla , eliza ) <eos>	dislike ( isla , eliza ) <eos>
henry throws zelda <eos>	throw ( henry , zelda ) <eos>	throw ( henry , zelda ) <eos>
claire dislikes neha <eos>	dislike ( claire , neha ) <eos>	dislike ( claire , neha ) <eos>
john likes zelda <eos>	like ( john , zelda ) <eos>	like ( john , zelda ) <eos>
claire throws tracy <eos>	throw ( claire , tracy ) <eos>	throw ( claire , tracy ) <eos>
yvette throws isla <eos>	throw ( yvettte , isla ) <eos>	throw ( yvettte , isla ) <eos>
samuel dislikes isla <eos>	dislike ( samuel , isla ) <eos>	dislike ( samuel , isla ) <eos>
katherine likes yvette <eos>	like ( katherine , yvettte ) <eos>	like ( katherine , yvettte ) <eos>
alice throws quinn <eos>	throw ( alice , quinn ) <eos>	throw ( alice , quinn ) <eos>
xerxes likes rachael <eos>	like ( xerxes , rachael ) <eos>	like ( xerxes , rachael ) <eos>
rachael throws claire <eos>	throw ( rachael , claire ) <eos>	throw ( rachael , claire ) <eos>
eliza sees victor <eos>	see ( eliza , victor ) <eos>	see ( eliza , victor ) <eos>
xerxes notices francis <eos>	notice ( xerxes , francis ) <eos>	notice ( xerxes , francis ) <eos>
zelda meets victor <eos>	meet ( zelda , victor ) <eos>	meet ( zelda , victor ) <eos>
francis sees patricia <eos>	see ( francis , patricia ) <eos>	see ( francis , patricia ) <eos>
oswald dislikes neha <eos>	dislike ( oswald , neha ) <eos>	dislike ( oswald , neha ) <eos>
samuel notices claire <eos>	notice ( samuel , claire ) <eos>	notice ( samuel , claire ) <eos>
winnifred knows katherine <eos>	know ( winnifred , katherine ) <eos>	know ( winnifred , katherine ) <eos>
yvette notices rachael <eos>	notice ( yvettte , rachael ) <eos>	notice ( yvettte , rachael ) <eos>
neha throws herself <eos>	throw ( neha , neha ) <eos>	throw ( neha , neha ) <eos>
zelda sees patricia <eos>	see ( zelda , patricia ) <eos>	see ( zelda , patricia ) <eos>
patricia meets rachael <eos>	meet ( patricia , rachael ) <eos>	meet ( patricia , rachael ) <eos>
isla meets john <eos>	meet ( isla , john ) <eos>	meet ( isla , john ) <eos>
victor sees lewis <eos>	see ( victor , lewis ) <eos>	see ( victor , lewis ) <eos>
oswald dislikes ursula <eos>	dislike ( oswald , ursula ) <eos>	dislike ( oswald , ursula ) <eos>
katherine throws eliza <eos>	throw ( katherine , eliza ) <eos>	throw ( katherine , eliza ) <eos>
john notices grace <eos>	notice ( john , grace ) <eos>	notice ( john , grace ) <eos>
tracy meets claire <eos>	meet ( tracy , claire ) <eos>	meet ( tracy , claire ) <eos>
isla knows alice <eos>	know ( isla , alice ) <eos>	know ( isla , alice ) <eos>
bob sees grace <eos>	see ( bob , grace ) <eos>	see ( bob , grace ) <eos>
quinn throws zelda <eos>	throw ( quinn , zelda ) <eos>	throw ( quinn , zelda ) <eos>
eliza notices john <eos>	notice ( eliza , john ) <eos>	notice ( eliza , john ) <eos>
quinn throws isla <eos>	throw ( quinn , isla ) <eos>	throw ( quinn , isla ) <eos>
eliza sees claire <eos>	see ( eliza , claire ) <eos>	see ( eliza , claire ) <eos>
samuel notices daniel <eos>	notice ( samuel , daniel ) <eos>	notice ( samuel , daniel ) <eos>
isla dislikes yvette <eos>	dislike ( isla , yvettte ) <eos>	dislike ( isla , yvettte ) <eos>
yvette sees oswald <eos>	see ( yvettte , oswald ) <eos>	see ( yvettte , oswald ) <eos>
rachael dislikes katherine <eos>	dislike ( rachael , katherine ) <eos>	dislike ( rachael , katherine ) <eos>
isla knows john <eos>	know ( isla , john ) <eos>	know ( isla , john ) <eos>
isla throws katherine <eos>	throw ( isla , katherine ) <eos>	throw ( isla , katherine ) <eos>
isla notices daniel <eos>	notice ( isla , daniel ) <eos>	notice ( isla , daniel ) <eos>
tracy likes quinn <eos>	like ( tracy , quinn ) <eos>	like ( tracy , quinn ) <eos>
henry knows daniel <eos>	know ( henry , daniel ) <eos>	know ( henry , daniel ) <eos>
alice likes ursula <eos>	like ( alice , ursula ) <eos>	like ( alice , ursula ) <eos>
margaret throws francis <eos>	throw ( margaret , francis ) <eos>	throw ( margaret , francis ) <eos>
francis throws isla <eos>	throw ( francis , isla ) <eos>	throw ( francis , isla ) <eos>
rachael meets quinn <eos>	meet ( rachael , quinn ) <eos>	meet ( rachael , quinn ) <eos>
isla sees neha <eos>	see ( isla , neha ) <eos>	see ( isla , neha ) <eos>
henry knows grace <eos>	know ( henry , grace ) <eos>	know ( henry , grace ) <eos>
katherine sees grace <eos>	see ( katherine , grace ) <eos>	see ( katherine , grace ) <eos>
lewis meets oswald <eos>	meet ( lewis , oswald ) <eos>	meet ( lewis , oswald ) <eos>
yvette knows samuel <eos>	know ( yvettte , samuel ) <eos>	know ( yvettte , samuel ) <eos>
yvette dislikes victor <eos>	dislike ( yvettte , victor ) <eos>	dislike ( yvettte , victor ) <eos>
katherine throws quinn <eos>	throw ( katherine , quinn ) <eos>	throw ( katherine , quinn ) <eos>
neha throws oswald <eos>	throw ( neha , oswald ) <eos>	throw ( neha , oswald ) <eos>
patricia knows rachael <eos>	know ( patricia , rachael ) <eos>	know ( patricia , rachael ) <eos>
oswald meets bob <eos>	meet ( oswald , bob ) <eos>	meet ( oswald , bob ) <eos>
zelda sees john <eos>	see ( zelda , john ) <eos>	see ( zelda , john ) <eos>
tracy sees grace <eos>	see ( tracy , grace ) <eos>	see ( tracy , grace ) <eos>
patricia meets yvette <eos>	meet ( patricia , yvettte ) <eos>	meet ( patricia , yvettte ) <eos>
tracy knows bob <eos>	know ( tracy , bob ) <eos>	know ( tracy , bob ) <eos>
tracy knows rachael <eos>	know ( tracy , rachael ) <eos>	know ( tracy , rachael ) <eos>
neha throws eliza <eos>	throw ( neha , eliza ) <eos>	throw ( neha , eliza ) <eos>
patricia dislikes eliza <eos>	dislike ( patricia , eliza ) <eos>	dislike ( patricia , eliza ) <eos>
daniel dislikes rachael <eos>	dislike ( daniel , rachael ) <eos>	dislike ( daniel , rachael ) <eos>
katherine sees zelda <eos>	see ( katherine , zelda ) <eos>	see ( katherine , zelda ) <eos>
alice knows oswald <eos>	know ( alice , oswald ) <eos>	know ( alice , oswald ) <eos>
margaret throws samuel <eos>	throw ( margaret , samuel ) <eos>	throw ( margaret , samuel ) <eos>
alice sees margaret <eos>	see ( alice , margaret ) <eos>	see ( alice , margaret ) <eos>
patricia sees grace <eos>	see ( patricia , grace ) <eos>	see ( patricia , grace ) <eos>
grace knows lewis <eos>	know ( grace , lewis ) <eos>	know ( grace , lewis ) <eos>
francis likes eliza <eos>	like ( francis , eliza ) <eos>	like ( francis , eliza ) <eos>
eliza likes winnifred <eos>	like ( eliza , winnifred ) <eos>	like ( eliza , winnifred ) <eos>
isla throws victor <eos>	throw ( isla , victor ) <eos>	throw ( isla , victor ) <eos>
patricia sees margaret <eos>	see ( patricia , margaret ) <eos>	see ( patricia , margaret ) <eos>
isla knows francis <eos>	know ( isla , francis ) <eos>	know ( isla , francis ) <eos>
alice throws ursula <eos>	throw ( alice , ursula ) <eos>	throw ( alice , ursula ) <eos>
ursula knows francis <eos>	know ( ursula , francis ) <eos>	know ( ursula , francis ) <eos>
victor likes henry <eos>	like ( victor , henry ) <eos>	like ( victor , henry ) <eos>
francis dislikes rachael <eos>	dislike ( francis , rachael ) <eos>	dislike ( francis , rachael ) <eos>
samuel notices winnifred <eos>	notice ( samuel , winnifred ) <eos>	notice ( samuel , winnifred ) <eos>
patricia throws rachael <eos>	throw ( patricia , rachael ) <eos>	throw ( patricia , rachael ) <eos>
patricia knows xerxes <eos>	know ( patricia , xerxes ) <eos>	know ( patricia , xerxes ) <eos>
samuel meets eliza <eos>	meet ( samuel , eliza ) <eos>	meet ( samuel , eliza ) <eos>
patricia meets katherine <eos>	meet ( patricia , katherine ) <eos>	meet ( patricia , katherine ) <eos>
katherine likes winnifred <eos>	like ( katherine , winnifred ) <eos>	like ( katherine , winnifred ) <eos>
samuel knows winnifred <eos>	know ( samuel , winnifred ) <eos>	know ( samuel , winnifred ) <eos>
winnifred notices oswald <eos>	notice ( winnifred , oswald ) <eos>	notice ( winnifred , oswald ) <eos>
margaret knows oswald <eos>	know ( margaret , oswald ) <eos>	know ( margaret , oswald ) <eos>
francis dislikes john <eos>	dislike ( francis , john ) <eos>	dislike ( francis , john ) <eos>
samuel dislikes rachael <eos>	dislike ( samuel , rachael ) <eos>	dislike ( samuel , rachael ) <eos>
margaret notices claire <eos>	notice ( margaret , claire ) <eos>	notice ( margaret , claire ) <eos>
daniel notices victor <eos>	notice ( daniel , victor ) <eos>	notice ( daniel , victor ) <eos>
patricia notices daniel <eos>	notice ( patricia , daniel ) <eos>	notice ( patricia , daniel ) <eos>
oswald likes henry <eos>	like ( oswald , henry ) <eos>	like ( oswald , henry ) <eos>
bob knows quinn <eos>	know ( bob , quinn ) <eos>	know ( bob , quinn ) <eos>
lewis knows yvette <eos>	know ( lewis , yvettte ) <eos>	know ( lewis , yvettte ) <eos>
zelda dislikes lewis <eos>	dislike ( zelda , lewis ) <eos>	dislike ( zelda , lewis ) <eos>
samuel throws rachael <eos>	throw ( samuel , rachael ) <eos>	throw ( samuel , rachael ) <eos>
rachael sees tracy <eos>	see ( rachael , tracy ) <eos>	see ( rachael , tracy ) <eos>
quinn dislikes henry <eos>	dislike ( quinn , henry ) <eos>	dislike ( quinn , henry ) <eos>
grace notices victor <eos>	notice ( grace , victor ) <eos>	notice ( grace , victor ) <eos>
rachael notices francis <eos>	notice ( rachael , francis ) <eos>	notice ( rachael , francis ) <eos>
ursula notices isla <eos>	notice ( ursula , isla ) <eos>	notice ( ursula , isla ) <eos>
katherine knows katherine <eos>	know ( katherine , katherine ) <eos>	know ( katherine , katherine ) <eos>
rachael knows ursula <eos>	know ( rachael , ursula ) <eos>	know ( rachael , ursula ) <eos>
winnifred sees winnifred <eos>	see ( winnifred , winnifred ) <eos>	see ( winnifred , winnifred ) <eos>
rachael throws patricia <eos>	throw ( rachael , patricia ) <eos>	throw ( rachael , patricia ) <eos>
tracy dislikes samuel <eos>	dislike ( tracy , samuel ) <eos>	dislike ( tracy , samuel ) <eos>
ursula meets lewis <eos>	meet ( ursula , lewis ) <eos>	meet ( ursula , lewis ) <eos>
zelda dislikes margaret <eos>	dislike ( zelda , margaret ) <eos>	dislike ( zelda , margaret ) <eos>
bob likes bob <eos>	like ( bob , bob ) <eos>	like ( bob , bob ) <eos>
claire throws katherine <eos>	throw ( claire , katherine ) <eos>	throw ( claire , katherine ) <eos>
grace sees isla <eos>	see ( grace , isla ) <eos>	see ( grace , isla ) <eos>
oswald sees ursula <eos>	see ( oswald , ursula ) <eos>	see ( oswald , ursula ) <eos>
neha meets katherine <eos>	meet ( neha , katherine ) <eos>	meet ( neha , katherine ) <eos>
daniel dislikes henry <eos>	dislike ( daniel , henry ) <eos>	dislike ( daniel , henry ) <eos>
samuel sees zelda <eos>	see ( samuel , zelda ) <eos>	see ( samuel , zelda ) <eos>
neha meets daniel <eos>	meet ( neha , daniel ) <eos>	meet ( neha , daniel ) <eos>
eliza likes herself <eos>	like ( eliza , eliza ) <eos>	like ( eliza , eliza ) <eos>
zelda throws eliza <eos>	throw ( zelda , eliza ) <eos>	throw ( zelda , eliza ) <eos>
grace throws eliza <eos>	throw ( grace , eliza ) <eos>	throw ( grace , eliza ) <eos>
francis likes neha <eos>	like ( francis , neha ) <eos>	like ( francis , neha ) <eos>
francis notices eliza <eos>	notice ( francis , eliza ) <eos>	notice ( francis , eliza ) <eos>
winnifred knows herself <eos>	know ( winnifred , winnifred ) <eos>	know ( winnifred , winnifred ) <eos>
henry likes tracy <eos>	like ( henry , tracy ) <eos>	like ( henry , tracy ) <eos>
xerxes likes henry <eos>	like ( xerxes , henry ) <eos>	like ( xerxes , henry ) <eos>
katherine knows henry <eos>	know ( katherine , henry ) <eos>	know ( katherine , henry ) <eos>
ursula sees henry <eos>	see ( ursula , henry ) <eos>	see ( ursula , henry ) <eos>
victor dislikes ursula <eos>	dislike ( victor , ursula ) <eos>	dislike ( victor , ursula ) <eos>
lewis likes bob <eos>	like ( lewis , bob ) <eos>	like ( lewis , bob ) <eos>
isla throws claire <eos>	throw ( isla , claire ) <eos>	throw ( isla , claire ) <eos>
oswald notices victor <eos>	notice ( oswald , victor ) <eos>	notice ( oswald , victor ) <eos>
quinn notices bob <eos>	notice ( quinn , bob ) <eos>	notice ( quinn , bob ) <eos>
ursula sees isla <eos>	see ( ursula , isla ) <eos>	see ( ursula , isla ) <eos>
winnifred notices eliza <eos>	notice ( winnifred , eliza ) <eos>	notice ( winnifred , eliza ) <eos>
zelda notices neha <eos>	notice ( zelda , neha ) <eos>	notice ( zelda , neha ) <eos>
winnifred throws ursula <eos>	throw ( winnifred , ursula ) <eos>	throw ( winnifred , ursula ) <eos>
lewis throws eliza <eos>	throw ( lewis , eliza ) <eos>	throw ( lewis , eliza ) <eos>
winnifred sees tracy <eos>	see ( winnifred , tracy ) <eos>	see ( winnifred , tracy ) <eos>
victor likes winnifred <eos>	like ( victor , winnifred ) <eos>	like ( victor , winnifred ) <eos>
grace sees yvette <eos>	see ( grace , yvettte ) <eos>	see ( grace , yvettte ) <eos>
zelda throws yvette <eos>	throw ( zelda , yvettte ) <eos>	throw ( zelda , yvettte ) <eos>
alice sees herself <eos>	see ( alice , alice ) <eos>	see ( alice , alice ) <eos>
alice meets eliza <eos>	meet ( alice , eliza ) <eos>	meet ( alice , eliza ) <eos>
winnifred likes victor <eos>	like ( winnifred , victor ) <eos>	like ( winnifred , victor ) <eos>
henry meets tracy <eos>	meet ( henry , tracy ) <eos>	meet ( henry , tracy ) <eos>
samuel meets neha <eos>	meet ( samuel , neha ) <eos>	meet ( samuel , neha ) <eos>
john meets oswald <eos>	meet ( john , oswald ) <eos>	meet ( john , oswald ) <eos>
quinn notices john <eos>	notice ( quinn , john ) <eos>	notice ( quinn , john ) <eos>
rachael meets katherine <eos>	meet ( rachael , katherine ) <eos>	meet ( rachael , katherine ) <eos>
bob throws isla <eos>	throw ( bob , isla ) <eos>	throw ( bob , isla ) <eos>
eliza likes bob <eos>	like ( eliza , bob ) <eos>	like ( eliza , bob ) <eos>
zelda meets claire <eos>	meet ( zelda , claire ) <eos>	meet ( zelda , claire ) <eos>
daniel throws yvette <eos>	throw ( daniel , yvettte ) <eos>	throw ( daniel , yvettte ) <eos>
neha dislikes winnifred <eos>	dislike ( neha , winnifred ) <eos>	dislike ( neha , winnifred ) <eos>
victor dislikes samuel <eos>	dislike ( victor , samuel ) <eos>	dislike ( victor , samuel ) <eos>
lewis sees winnifred <eos>	see ( lewis , winnifred ) <eos>	see ( lewis , winnifred ) <eos>
xerxes likes himself <eos>	like ( xerxes , xerxes ) <eos>	like ( xerxes , xerxes ) <eos>
yvette meets margaret <eos>	meet ( yvettte , margaret ) <eos>	meet ( yvettte , margaret ) <eos>
alice likes isla <eos>	like ( alice , isla ) <eos>	like ( alice , isla ) <eos>
eliza throws yvette <eos>	throw ( eliza , yvettte ) <eos>	throw ( eliza , yvettte ) <eos>
rachael meets francis <eos>	meet ( rachael , francis ) <eos>	meet ( rachael , francis ) <eos>
bob likes xerxes <eos>	like ( bob , xerxes ) <eos>	like ( bob , xerxes ) <eos>
john likes lewis <eos>	like ( john , lewis ) <eos>	like ( john , lewis ) <eos>
victor notices daniel <eos>	notice ( victor , daniel ) <eos>	notice ( victor , daniel ) <eos>
zelda notices alice <eos>	notice ( zelda , alice ) <eos>	notice ( zelda , alice ) <eos>
oswald notices winnifred <eos>	notice ( oswald , winnifred ) <eos>	notice ( oswald , winnifred ) <eos>
quinn sees katherine <eos>	see ( quinn , katherine ) <eos>	see ( quinn , katherine ) <eos>
claire notices john <eos>	notice ( claire , john ) <eos>	notice ( claire , john ) <eos>
katherine meets claire <eos>	meet ( katherine , claire ) <eos>	meet ( katherine , claire ) <eos>
katherine throws claire <eos>	throw ( katherine , claire ) <eos>	throw ( katherine , claire ) <eos>
francis dislikes grace <eos>	dislike ( francis , grace ) <eos>	dislike ( francis , grace ) <eos>
katherine meets oswald <eos>	meet ( katherine , oswald ) <eos>	meet ( katherine , oswald ) <eos>
isla throws samuel <eos>	throw ( isla , samuel ) <eos>	throw ( isla , samuel ) <eos>
victor meets claire <eos>	meet ( victor , claire ) <eos>	meet ( victor , claire ) <eos>
katherine throws victor <eos>	throw ( katherine , victor ) <eos>	throw ( katherine , victor ) <eos>
daniel knows alice <eos>	know ( daniel , alice ) <eos>	know ( daniel , alice ) <eos>
alice notices herself <eos>	notice ( alice , alice ) <eos>	notice ( alice , alice ) <eos>
xerxes dislikes xerxes <eos>	dislike ( xerxes , xerxes ) <eos>	dislike ( xerxes , xerxes ) <eos>
lewis meets victor <eos>	meet ( lewis , victor ) <eos>	meet ( lewis , victor ) <eos>
daniel likes margaret <eos>	like ( daniel , margaret ) <eos>	like ( daniel , margaret ) <eos>
victor notices yvette <eos>	notice ( victor , yvettte ) <eos>	notice ( victor , yvettte ) <eos>
katherine likes isla <eos>	like ( katherine , isla ) <eos>	like ( katherine , isla ) <eos>
ursula meets henry <eos>	meet ( ursula , henry ) <eos>	meet ( ursula , henry ) <eos>
ursula throws quinn <eos>	throw ( ursula , quinn ) <eos>	throw ( ursula , quinn ) <eos>
grace knows winnifred <eos>	know ( grace , winnifred ) <eos>	know ( grace , winnifred ) <eos>
winnifred notices ursula <eos>	notice ( winnifred , ursula ) <eos>	notice ( winnifred , ursula ) <eos>
neha throws tracy <eos>	throw ( neha , tracy ) <eos>	throw ( neha , tracy ) <eos>
rachael notices eliza <eos>	notice ( rachael , eliza ) <eos>	notice ( rachael , eliza ) <eos>
alice likes herself <eos>	like ( alice , alice ) <eos>	like ( alice , alice ) <eos>
rachael sees margaret <eos>	see ( rachael , margaret ) <eos>	see ( rachael , margaret ) <eos>
quinn throws eliza <eos>	throw ( quinn , eliza ) <eos>	throw ( quinn , eliza ) <eos>
ursula meets eliza <eos>	meet ( ursula , eliza ) <eos>	meet ( ursula , eliza ) <eos>
alice notices tracy <eos>	notice ( alice , tracy ) <eos>	notice ( alice , tracy ) <eos>
lewis throws ursula <eos>	throw ( lewis , ursula ) <eos>	throw ( lewis , ursula ) <eos>
patricia knows alice <eos>	know ( patricia , alice ) <eos>	know ( patricia , alice ) <eos>
quinn dislikes tracy <eos>	dislike ( quinn , tracy ) <eos>	dislike ( quinn , tracy ) <eos>
grace dislikes winnifred <eos>	dislike ( grace , winnifred ) <eos>	dislike ( grace , winnifred ) <eos>
eliza throws winnifred <eos>	throw ( eliza , winnifred ) <eos>	throw ( eliza , winnifred ) <eos>
samuel meets claire <eos>	meet ( samuel , claire ) <eos>	meet ( samuel , claire ) <eos>
neha meets neha <eos>	meet ( neha , neha ) <eos>	meet ( neha , neha ) <eos>
margaret dislikes quinn <eos>	dislike ( margaret , quinn ) <eos>	dislike ( margaret , quinn ) <eos>
samuel throws patricia <eos>	throw ( samuel , patricia ) <eos>	throw ( samuel , patricia ) <eos>
claire notices ursula <eos>	notice ( claire , ursula ) <eos>	notice ( claire , ursula ) <eos>
xerxes notices zelda <eos>	notice ( xerxes , zelda ) <eos>	notice ( xerxes , zelda ) <eos>
lewis likes isla <eos>	like ( lewis , isla ) <eos>	like ( lewis , isla ) <eos>
margaret likes winnifred <eos>	like ( margaret , winnifred ) <eos>	like ( margaret , winnifred ) <eos>
neha throws winnifred <eos>	throw ( neha , winnifred ) <eos>	throw ( neha , winnifred ) <eos>
eliza knows henry <eos>	know ( eliza , henry ) <eos>	know ( eliza , henry ) <eos>
john dislikes lewis <eos>	dislike ( john , lewis ) <eos>	dislike ( john , lewis ) <eos>
victor sees john <eos>	see ( victor , john ) <eos>	see ( victor , john ) <eos>
oswald dislikes himself <eos>	dislike ( oswald , oswald ) <eos>	dislike ( oswald , oswald ) <eos>
patricia sees oswald <eos>	see ( patricia , oswald ) <eos>	see ( patricia , oswald ) <eos>
quinn knows tracy <eos>	know ( quinn , tracy ) <eos>	know ( quinn , tracy ) <eos>
john dislikes isla <eos>	dislike ( john , isla ) <eos>	dislike ( john , isla ) <eos>
patricia dislikes ursula <eos>	dislike ( patricia , ursula ) <eos>	dislike ( patricia , ursula ) <eos>
oswald sees eliza <eos>	see ( oswald , eliza ) <eos>	see ( oswald , eliza ) <eos>
henry knows neha <eos>	know ( henry , neha ) <eos>	know ( henry , neha ) <eos>
margaret likes daniel <eos>	like ( margaret , daniel ) <eos>	like ( margaret , daniel ) <eos>
samuel notices eliza <eos>	notice ( samuel , eliza ) <eos>	notice ( samuel , eliza ) <eos>
grace meets oswald <eos>	meet ( grace , oswald ) <eos>	meet ( grace , oswald ) <eos>
francis likes victor <eos>	like ( francis , victor ) <eos>	like ( francis , victor ) <eos>
neha walks <eos>	walk ( neha ) <eos>	walk ( neha ) <eos>
patricia sings <eos>	sing ( patricia ) <eos>	sing ( patricia ) <eos>
eliza sings <eos>	sing ( eliza ) <eos>	sing ( eliza ) <eos>
xerxes eats <eos>	eat ( xerxes ) <eos>	eat ( xerxes ) <eos>
katherine sings <eos>	sing ( katherine ) <eos>	sing ( katherine ) <eos>
john meets quinn <eos>	meet ( john , quinn ) <eos>	meet ( john , quinn ) <eos>
quinn likes alice <eos>	like ( quinn , alice ) <eos>	like ( quinn , alice ) <eos>
quinn meets margaret <eos>	meet ( quinn , margaret ) <eos>	meet ( quinn , margaret ) <eos>
daniel likes samuel <eos>	like ( daniel , samuel ) <eos>	like ( daniel , samuel ) <eos>
rachael dislikes tracy <eos>	dislike ( rachael , tracy ) <eos>	dislike ( rachael , tracy ) <eos>
bob meets ursula <eos>	meet ( bob , ursula ) <eos>	meet ( bob , ursula ) <eos>
katherine sees claire <eos>	see ( katherine , claire ) <eos>	see ( katherine , claire ) <eos>
john throws francis <eos>	throw ( john , francis ) <eos>	throw ( john , francis ) <eos>
ursula knows patricia <eos>	know ( ursula , patricia ) <eos>	know ( ursula , patricia ) <eos>
grace notices tracy <eos>	notice ( grace , tracy ) <eos>	notice ( grace , tracy ) <eos>
