source	target	prediction
francis dances <eos>	dance ( francis ) <eos>	dance ( francis ) <eos> walk walk walk walk walk walk walk walk walk walk walk walk walk walk walk walk walk walk walk walk walk walk walk walk walk
eliza sings <eos>	sing ( eliza ) <eos>	sing ( eliza ) <eos> walk walk walk walk walk walk walk walk walk walk walk walk walk walk walk walk walk walk walk walk walk walk walk walk walk
eliza runs <eos>	run ( eliza ) <eos>	run ( eliza ) <eos> walk walk walk walk walk walk walk walk walk walk walk walk walk walk walk walk walk walk walk walk walk walk walk walk walk
eliza eats <eos>	eat ( eliza ) <eos>	eat ( eliza ) <eos> walk walk walk walk walk walk walk walk walk walk walk walk walk walk walk walk walk walk walk walk walk walk walk walk walk
bob slumbers <eos>	slumber ( bob ) <eos>	slumber ( bob ) <eos> walk walk walk walk walk walk walk walk walk walk walk walk walk walk walk walk walk walk walk walk walk walk walk walk walk
margaret runs <eos>	run ( margaret ) <eos>	run ( margaret ) <eos> walk walk walk walk walk walk walk walk walk walk walk walk walk walk walk walk walk walk walk walk walk walk walk walk walk
katherine flies <eos>	fly ( katherine ) <eos>	fly ( katherine ) <eos> walk walk walk walk walk walk walk walk walk walk walk walk walk walk walk walk walk walk walk walk walk walk walk walk walk
henry slumbers <eos>	slumber ( henry ) <eos>	slumber ( henry ) <eos> walk walk walk walk walk walk walk walk walk walk walk walk walk walk walk walk walk walk walk walk walk walk walk walk walk
henry walks <eos>	walk ( henry ) <eos>	walk ( henry ) <eos> walk walk walk walk walk walk walk walk walk walk walk walk walk walk walk walk walk walk walk walk walk walk walk walk walk
grace sleeps <eos>	sleep ( grace ) <eos>	sleep ( grace ) <eos> walk walk walk walk walk walk walk walk walk walk walk walk walk walk walk walk walk walk walk walk walk walk walk walk walk
victor dances <eos>	dance ( victor ) <eos>	dance ( victor ) <eos> walk walk walk walk walk walk walk walk walk walk walk walk walk walk walk walk walk walk walk walk walk walk walk walk walk
victor sings <eos>	sing ( victor ) <eos>	sing ( victor ) <eos> walk walk walk walk walk walk walk walk walk walk walk walk walk walk walk walk walk walk walk walk walk walk walk walk walk
rachael flies <eos>	fly ( rachael ) <eos>	fly ( rachael ) <eos> walk walk walk walk walk walk walk walk walk walk walk walk walk walk walk walk walk walk walk walk walk walk walk walk walk
quinn walks <eos>	walk ( quinn ) <eos>	walk ( quinn ) <eos> walk walk walk walk walk walk walk walk walk walk walk walk walk walk walk walk walk walk walk walk walk walk walk walk walk
oswald runs <eos>	run ( oswald ) <eos>	run ( oswald ) <eos> walk walk walk walk walk walk walk walk walk walk walk walk walk walk walk walk walk walk walk walk walk walk walk walk walk
yvette flies <eos>	fly ( yvettte ) <eos>	fly ( yvettte ) <eos> walk walk walk walk walk walk walk walk walk walk walk walk walk walk walk walk walk walk walk walk walk walk walk walk walk
yvette sleeps <eos>	sleep ( yvettte ) <eos>	sleep ( yvettte ) <eos> walk walk walk walk walk walk walk walk walk walk walk walk walk walk walk walk walk walk walk walk walk walk walk walk walk
xerxes walks <eos>	walk ( xerxes ) <eos>	walk ( xerxes ) <eos> walk walk walk walk walk walk walk walk walk walk walk walk walk walk walk walk walk walk walk walk walk walk walk walk walk
winnifred sings <eos>	sing ( winnifred ) <eos>	sing ( winnifred ) <eos> walk walk walk walk walk walk walk walk walk walk walk walk walk walk walk walk walk walk walk walk walk walk walk walk walk
victor slumbers <eos>	slumber ( victor ) <eos>	slumber ( victor ) <eos> walk walk walk walk walk walk walk walk walk walk walk walk walk walk walk walk walk walk walk walk walk walk walk walk walk
alice meets katherine <eos>	meet ( alice , katherine ) <eos>	meet ( alice , katherine ) <eos> walk walk walk walk walk walk walk walk walk walk walk walk walk walk walk walk walk walk walk walk walk walk walk
alice sees tracy <eos>	see ( alice , tracy ) <eos>	see ( alice , tracy ) <eos> walk walk walk walk walk walk walk walk walk walk walk walk walk walk walk walk walk walk walk walk walk walk walk
alice sees neha <eos>	see ( alice , neha ) <eos>	see ( alice , neha ) <eos> walk walk walk walk walk walk walk walk walk walk walk walk walk walk walk walk walk walk walk walk walk walk walk
alice sees margaret <eos>	see ( alice , margaret ) <eos>	see ( alice , margaret ) <eos> walk walk walk walk walk walk walk walk walk walk walk walk walk walk walk walk walk walk walk walk walk walk walk
alice sees alice <eos>	see ( alice , alice ) <eos>	see ( alice , alice ) <eos> walk walk walk walk walk walk walk walk walk walk walk walk walk walk walk walk walk walk walk walk walk walk walk
alice likes winnifred <eos>	like ( alice , winnifred ) <eos>	like ( alice , winnifred ) <eos> walk walk walk walk walk walk walk walk walk walk walk walk walk walk walk walk walk walk walk walk walk walk walk
alice likes margaret <eos>	like ( alice , margaret ) <eos>	like ( alice , margaret ) <eos> walk walk walk walk walk walk walk walk walk walk walk walk walk walk walk walk walk walk walk walk walk walk walk
alice meets victor <eos>	meet ( alice , victor ) <eos>	meet ( alice , victor ) <eos> walk walk walk walk walk walk walk walk walk walk walk walk walk walk walk walk walk walk walk walk walk walk walk
alice meets quinn <eos>	meet ( alice , quinn ) <eos>	meet ( alice , quinn ) <eos> walk walk walk walk walk walk walk walk walk walk walk walk walk walk walk walk walk walk walk walk walk walk walk
alice meets patricia <eos>	meet ( alice , patricia ) <eos>	meet ( alice , patricia ) <eos> walk walk walk walk walk walk walk walk walk walk walk walk walk walk walk walk walk walk walk walk walk walk walk
alice throws yvette <eos>	throw ( alice , yvettte ) <eos>	throw ( alice , yvettte ) <eos> walk walk walk walk walk walk walk walk walk walk walk walk walk walk walk walk walk walk walk walk walk walk walk
alice throws tracy <eos>	throw ( alice , tracy ) <eos>	throw ( alice , tracy ) <eos> walk walk walk walk walk walk walk walk walk walk walk walk walk walk walk walk walk walk walk walk walk walk walk
alice throws margaret <eos>	throw ( alice , margaret ) <eos>	throw ( alice , margaret ) <eos> walk walk walk walk walk walk walk walk walk walk walk walk walk walk walk walk walk walk walk walk walk walk walk
alice dislikes tracy <eos>	dislike ( alice , tracy ) <eos>	dislike ( alice , tracy ) <eos> walk walk walk walk walk walk walk walk walk walk walk walk walk walk walk walk walk walk walk walk walk walk walk
alice dislikes margaret <eos>	dislike ( alice , margaret ) <eos>	dislike ( alice , margaret ) <eos> walk walk walk walk walk walk walk walk walk walk walk walk walk walk walk walk walk walk walk walk walk walk walk
alice knows claire <eos>	know ( alice , claire ) <eos>	know ( alice , claire ) <eos> walk walk walk walk walk walk walk walk walk walk walk walk walk walk walk walk walk walk walk walk walk walk walk
alice knows bob <eos>	know ( alice , bob ) <eos>	know ( alice , bob ) <eos> walk walk walk walk walk walk walk walk walk walk walk walk walk walk walk walk walk walk walk walk walk walk walk
alice notices oswald <eos>	notice ( alice , oswald ) <eos>	notice ( alice , oswald ) <eos> walk walk walk walk walk walk walk walk walk walk walk walk walk walk walk walk walk walk walk walk walk walk walk
alice notices francis <eos>	notice ( alice , francis ) <eos>	notice ( alice , francis ) <eos> walk walk walk walk walk walk walk walk walk walk walk walk walk walk walk walk walk walk walk walk walk walk walk
alice notices claire <eos>	notice ( alice , claire ) <eos>	notice ( alice , claire ) <eos> walk walk walk walk walk walk walk walk walk walk walk walk walk walk walk walk walk walk walk walk walk walk walk
alice knows john <eos>	know ( alice , john ) <eos>	know ( alice , john ) <eos> walk walk walk walk walk walk walk walk walk walk walk walk walk walk walk walk walk walk walk walk walk walk walk
alice knows isla <eos>	know ( alice , isla ) <eos>	know ( alice , isla ) <eos> walk walk walk walk walk walk walk walk walk walk walk walk walk walk walk walk walk walk walk walk walk walk walk
alice knows henry <eos>	know ( alice , henry ) <eos>	know ( alice , henry ) <eos> walk walk walk walk walk walk walk walk walk walk walk walk walk walk walk walk walk walk walk walk walk walk walk
alice knows francis <eos>	know ( alice , francis ) <eos>	know ( alice , francis ) <eos> walk walk walk walk walk walk walk walk walk walk walk walk walk walk walk walk walk walk walk walk walk walk walk
alice knows eliza <eos>	know ( alice , eliza ) <eos>	know ( alice , eliza ) <eos> walk walk walk walk walk walk walk walk walk walk walk walk walk walk walk walk walk walk walk walk walk walk walk
alice likes herself <eos>	like ( alice , alice ) <eos>	like ( alice , alice ) <eos> walk walk walk walk walk walk walk walk walk walk walk walk walk walk walk walk walk walk walk walk walk walk walk
alice meets herself <eos>	meet ( alice , alice ) <eos>	meet ( alice , alice ) <eos> walk walk walk walk walk walk walk walk walk walk walk walk walk walk walk walk walk walk walk walk walk walk walk
alice sees herself <eos>	see ( alice , alice ) <eos>	see ( alice , alice ) <eos> walk walk walk walk walk walk walk walk walk walk walk walk walk walk walk walk walk walk walk walk walk walk walk
alice knows zelda <eos>	know ( alice , zelda ) <eos>	know ( alice , zelda ) <eos> walk walk walk walk walk walk walk walk walk walk walk walk walk walk walk walk walk walk walk walk walk walk walk
alice knows patricia <eos>	know ( alice , patricia ) <eos>	know ( alice , patricia ) <eos> walk walk walk walk walk walk walk walk walk walk walk walk walk walk walk walk walk walk walk walk walk walk walk
bob sees quinn <eos>	see ( bob , quinn ) <eos>	see ( bob , quinn ) <eos> walk walk walk walk walk walk walk walk walk walk walk walk walk walk walk walk walk walk walk walk walk walk walk
alice knows herself <eos>	know ( alice , alice ) <eos>	know ( alice , alice ) <eos> walk walk walk walk walk walk walk walk walk walk walk walk walk walk walk walk walk walk walk walk walk walk walk
alice notices herself <eos>	notice ( alice , alice ) <eos>	notice ( alice , alice ) <eos> walk walk walk walk walk walk walk walk walk walk walk walk walk walk walk walk walk walk walk walk walk walk walk
alice throws herself <eos>	throw ( alice , alice ) <eos>	throw ( alice , alice ) <eos> walk walk walk walk walk walk walk walk walk walk walk walk walk walk walk walk walk walk walk walk walk walk walk
alice dislikes herself <eos>	dislike ( alice , alice ) <eos>	dislike ( alice , alice ) <eos> walk walk walk walk walk walk walk walk walk walk walk walk walk walk walk walk walk walk walk walk walk walk walk
bob meets ursula <eos>	meet ( bob , ursula ) <eos>	meet ( bob , ursula ) <eos> walk walk walk walk walk walk walk walk walk walk walk walk walk walk walk walk walk walk walk walk walk walk walk
bob meets isla <eos>	meet ( bob , isla ) <eos>	meet ( bob , isla ) <eos> walk walk walk walk walk walk walk walk walk walk walk walk walk walk walk walk walk walk walk walk walk walk walk
bob meets bob <eos>	meet ( bob , bob ) <eos>	meet ( bob , bob ) <eos> walk walk walk walk walk walk walk walk walk walk walk walk walk walk walk walk walk walk walk walk walk walk walk
bob sees yvette <eos>	see ( bob , yvettte ) <eos>	see ( bob , yvettte ) <eos> walk walk walk walk walk walk walk walk walk walk walk walk walk walk walk walk walk walk walk walk walk walk walk
bob sees ursula <eos>	see ( bob , ursula ) <eos>	see ( bob , ursula ) <eos> walk walk walk walk walk walk walk walk walk walk walk walk walk walk walk walk walk walk walk walk walk walk walk
bob throws claire <eos>	throw ( bob , claire ) <eos>	throw ( bob , claire ) <eos> walk walk walk walk walk walk walk walk walk walk walk walk walk walk walk walk walk walk walk walk walk walk walk
bob dislikes margaret <eos>	dislike ( bob , margaret ) <eos>	dislike ( bob , margaret ) <eos> walk walk walk walk walk walk walk walk walk walk walk walk walk walk walk walk walk walk walk walk walk walk walk
bob likes winnifred <eos>	like ( bob , winnifred ) <eos>	like ( bob , winnifred ) <eos> walk walk walk walk walk walk walk walk walk walk walk walk walk walk walk walk walk walk walk walk walk walk walk
bob likes margaret <eos>	like ( bob , margaret ) <eos>	like ( bob , margaret ) <eos> walk walk walk walk walk walk walk walk walk walk walk walk walk walk walk walk walk walk walk walk walk walk walk
bob likes katherine <eos>	like ( bob , katherine ) <eos>	like ( bob , katherine ) <eos> walk walk walk walk walk walk walk walk walk walk walk walk walk walk walk walk walk walk walk walk walk walk walk
bob notices lewis <eos>	notice ( bob , lewis ) <eos>	notice ( bob , lewis ) <eos> walk walk walk walk walk walk walk walk walk walk walk walk walk walk walk walk walk walk walk walk walk walk walk
bob notices john <eos>	notice ( bob , john ) <eos>	notice ( bob , john ) <eos> walk walk walk walk walk walk walk walk walk walk walk walk walk walk walk walk walk walk walk walk walk walk walk
bob throws victor <eos>	throw ( bob , victor ) <eos>	throw ( bob , victor ) <eos> walk walk walk walk walk walk walk walk walk walk walk walk walk walk walk walk walk walk walk walk walk walk walk
bob throws quinn <eos>	throw ( bob , quinn ) <eos>	throw ( bob , quinn ) <eos> walk walk walk walk walk walk walk walk walk walk walk walk walk walk walk walk walk walk walk walk walk walk walk
bob throws oswald <eos>	throw ( bob , oswald ) <eos>	throw ( bob , oswald ) <eos> walk walk walk walk walk walk walk walk walk walk walk walk walk walk walk walk walk walk walk walk walk walk walk
claire sees xerxes <eos>	see ( claire , xerxes ) <eos>	see ( claire , xerxes ) <eos> walk walk walk walk walk walk walk walk walk walk walk walk walk walk walk walk walk walk walk walk walk walk walk
claire sees isla <eos>	see ( claire , isla ) <eos>	see ( claire , isla ) <eos> walk walk walk walk walk walk walk walk walk walk walk walk walk walk walk walk walk walk walk walk walk walk walk
claire sees grace <eos>	see ( claire , grace ) <eos>	see ( claire , grace ) <eos> walk walk walk walk walk walk walk walk walk walk walk walk walk walk walk walk walk walk walk walk walk walk walk
bob throws himself <eos>	throw ( bob , bob ) <eos>	throw ( bob , bob ) <eos> walk walk walk walk walk walk walk walk walk walk walk walk walk walk walk walk walk walk walk walk walk walk walk
bob dislikes himself <eos>	dislike ( bob , bob ) <eos>	dislike ( bob , bob ) <eos> walk walk walk walk walk walk walk walk walk walk walk walk walk walk walk walk walk walk walk walk walk walk walk
claire dislikes lewis <eos>	dislike ( claire , lewis ) <eos>	dislike ( claire , lewis ) <eos> walk walk walk walk walk walk walk walk walk walk walk walk walk walk walk walk walk walk walk walk walk walk walk
claire likes grace <eos>	like ( claire , grace ) <eos>	like ( claire , grace ) <eos> walk walk walk walk walk walk walk walk walk walk walk walk walk walk walk walk walk walk walk walk walk walk walk
claire likes claire <eos>	like ( claire , claire ) <eos>	like ( claire , claire ) <eos> walk walk walk walk walk walk walk walk walk walk walk walk walk walk walk walk walk walk walk walk walk walk walk
claire likes alice <eos>	like ( claire , alice ) <eos>	like ( claire , alice ) <eos> walk walk walk walk walk walk walk walk walk walk walk walk walk walk walk walk walk walk walk walk walk walk walk
claire meets oswald <eos>	meet ( claire , oswald ) <eos>	meet ( claire , oswald ) <eos> walk walk walk walk walk walk walk walk walk walk walk walk walk walk walk walk walk walk walk walk walk walk walk
claire notices henry <eos>	notice ( claire , henry ) <eos>	notice ( claire , henry ) <eos> walk walk walk walk walk walk walk walk walk walk walk walk walk walk walk walk walk walk walk walk walk walk walk
claire throws zelda <eos>	throw ( claire , zelda ) <eos>	throw ( claire , zelda ) <eos> walk walk walk walk walk walk walk walk walk walk walk walk walk walk walk walk walk walk walk walk walk walk walk
claire throws xerxes <eos>	throw ( claire , xerxes ) <eos>	throw ( claire , xerxes ) <eos> walk walk walk walk walk walk walk walk walk walk walk walk walk walk walk walk walk walk walk walk walk walk walk
claire throws samuel <eos>	throw ( claire , samuel ) <eos>	throw ( claire , samuel ) <eos> walk walk walk walk walk walk walk walk walk walk walk walk walk walk walk walk walk walk walk walk walk walk walk
claire throws eliza <eos>	throw ( claire , eliza ) <eos>	throw ( claire , eliza ) <eos> walk walk walk walk walk walk walk walk walk walk walk walk walk walk walk walk walk walk walk walk walk walk walk
claire knows zelda <eos>	know ( claire , zelda ) <eos>	know ( claire , zelda ) <eos> walk walk walk walk walk walk walk walk walk walk walk walk walk walk walk walk walk walk walk walk walk walk walk
claire knows ursula <eos>	know ( claire , ursula ) <eos>	know ( claire , ursula ) <eos> walk walk walk walk walk walk walk walk walk walk walk walk walk walk walk walk walk walk walk walk walk walk walk
claire knows daniel <eos>	know ( claire , daniel ) <eos>	know ( claire , daniel ) <eos> walk walk walk walk walk walk walk walk walk walk walk walk walk walk walk walk walk walk walk walk walk walk walk
claire knows alice <eos>	know ( claire , alice ) <eos>	know ( claire , alice ) <eos> walk walk walk walk walk walk walk walk walk walk walk walk walk walk walk walk walk walk walk walk walk walk walk
claire notices katherine <eos>	notice ( claire , katherine ) <eos>	notice ( claire , katherine ) <eos> walk walk walk walk walk walk walk walk walk walk walk walk walk walk walk walk walk walk walk walk walk walk walk
daniel sees winnifred <eos>	see ( daniel , winnifred ) <eos>	see ( daniel , winnifred ) <eos> walk walk walk walk walk walk walk walk walk walk walk walk walk walk walk walk walk walk walk walk walk walk walk
daniel sees victor <eos>	see ( daniel , victor ) <eos>	see ( daniel , victor ) <eos> walk walk walk walk walk walk walk walk walk walk walk walk walk walk walk walk walk walk walk walk walk walk walk
daniel sees neha <eos>	see ( daniel , neha ) <eos>	see ( daniel , neha ) <eos> walk walk walk walk walk walk walk walk walk walk walk walk walk walk walk walk walk walk walk walk walk walk walk
daniel sees isla <eos>	see ( daniel , isla ) <eos>	see ( daniel , isla ) <eos> walk walk walk walk walk walk walk walk walk walk walk walk walk walk walk walk walk walk walk walk walk walk walk
claire notices herself <eos>	notice ( claire , claire ) <eos>	notice ( claire , claire ) <eos> walk walk walk walk walk walk walk walk walk walk walk walk walk walk walk walk walk walk walk walk walk walk walk
daniel dislikes rachael <eos>	dislike ( daniel , rachael ) <eos>	dislike ( daniel , rachael ) <eos> walk walk walk walk walk walk walk walk walk walk walk walk walk walk walk walk walk walk walk walk walk walk walk
daniel meets xerxes <eos>	meet ( daniel , xerxes ) <eos>	meet ( daniel , xerxes ) <eos> walk walk walk walk walk walk walk walk walk walk walk walk walk walk walk walk walk walk walk walk walk walk walk
daniel meets lewis <eos>	meet ( daniel , lewis ) <eos>	meet ( daniel , lewis ) <eos> walk walk walk walk walk walk walk walk walk walk walk walk walk walk walk walk walk walk walk walk walk walk walk
daniel meets eliza <eos>	meet ( daniel , eliza ) <eos>	meet ( daniel , eliza ) <eos> walk walk walk walk walk walk walk walk walk walk walk walk walk walk walk walk walk walk walk walk walk walk walk
daniel sees yvette <eos>	see ( daniel , yvettte ) <eos>	see ( daniel , yvettte ) <eos> walk walk walk walk walk walk walk walk walk walk walk walk walk walk walk walk walk walk walk walk walk walk walk
daniel knows claire <eos>	know ( daniel , claire ) <eos>	know ( daniel , claire ) <eos> walk walk walk walk walk walk walk walk walk walk walk walk walk walk walk walk walk walk walk walk walk walk walk
daniel notices margaret <eos>	notice ( daniel , margaret ) <eos>	notice ( daniel , margaret ) <eos> walk walk walk walk walk walk walk walk walk walk walk walk walk walk walk walk walk walk walk walk walk walk walk
daniel notices eliza <eos>	notice ( daniel , eliza ) <eos>	notice ( daniel , eliza ) <eos> walk walk walk walk walk walk walk walk walk walk walk walk walk walk walk walk walk walk walk walk walk walk walk
daniel throws victor <eos>	throw ( daniel , victor ) <eos>	throw ( daniel , victor ) <eos> walk walk walk walk walk walk walk walk walk walk walk walk walk walk walk walk walk walk walk walk walk walk walk
daniel dislikes winnifred <eos>	dislike ( daniel , winnifred ) <eos>	dislike ( daniel , winnifred ) <eos> walk walk walk walk walk walk walk walk walk walk walk walk walk walk walk walk walk walk walk walk walk walk walk
eliza meets henry <eos>	meet ( eliza , henry ) <eos>	meet ( eliza , henry ) <eos> walk walk walk walk walk walk walk walk walk walk walk walk walk walk walk walk walk walk walk walk walk walk walk
eliza meets alice <eos>	meet ( eliza , alice ) <eos>	meet ( eliza , alice ) <eos> walk walk walk walk walk walk walk walk walk walk walk walk walk walk walk walk walk walk walk walk walk walk walk
eliza sees alice <eos>	see ( eliza , alice ) <eos>	see ( eliza , alice ) <eos> walk walk walk walk walk walk walk walk walk walk walk walk walk walk walk walk walk walk walk walk walk walk walk
daniel knows henry <eos>	know ( daniel , henry ) <eos>	know ( daniel , henry ) <eos> walk walk walk walk walk walk walk walk walk walk walk walk walk walk walk walk walk walk walk walk walk walk walk
daniel knows eliza <eos>	know ( daniel , eliza ) <eos>	know ( daniel , eliza ) <eos> walk walk walk walk walk walk walk walk walk walk walk walk walk walk walk walk walk walk walk walk walk walk walk
eliza likes grace <eos>	like ( eliza , grace ) <eos>	like ( eliza , grace ) <eos> walk walk walk walk walk walk walk walk walk walk walk walk walk walk walk walk walk walk walk walk walk walk walk
eliza meets yvette <eos>	meet ( eliza , yvettte ) <eos>	meet ( eliza , yvettte ) <eos> walk walk walk walk walk walk walk walk walk walk walk walk walk walk walk walk walk walk walk walk walk walk walk
eliza meets victor <eos>	meet ( eliza , victor ) <eos>	meet ( eliza , victor ) <eos> walk walk walk walk walk walk walk walk walk walk walk walk walk walk walk walk walk walk walk walk walk walk walk
eliza meets patricia <eos>	meet ( eliza , patricia ) <eos>	meet ( eliza , patricia ) <eos> walk walk walk walk walk walk walk walk walk walk walk walk walk walk walk walk walk walk walk walk walk walk walk
eliza meets margaret <eos>	meet ( eliza , margaret ) <eos>	meet ( eliza , margaret ) <eos> walk walk walk walk walk walk walk walk walk walk walk walk walk walk walk walk walk walk walk walk walk walk walk
eliza notices john <eos>	notice ( eliza , john ) <eos>	notice ( eliza , john ) <eos> walk walk walk walk walk walk walk walk walk walk walk walk walk walk walk walk walk walk walk walk walk walk walk
eliza throws daniel <eos>	throw ( eliza , daniel ) <eos>	throw ( eliza , daniel ) <eos> walk walk walk walk walk walk walk walk walk walk walk walk walk walk walk walk walk walk walk walk walk walk walk
eliza throws alice <eos>	throw ( eliza , alice ) <eos>	throw ( eliza , alice ) <eos> walk walk walk walk walk walk walk walk walk walk walk walk walk walk walk walk walk walk walk walk walk walk walk
eliza dislikes eliza <eos>	dislike ( eliza , eliza ) <eos>	dislike ( eliza , eliza ) <eos> walk walk walk walk walk walk walk walk walk walk walk walk walk walk walk walk walk walk walk walk walk walk walk
eliza likes tracy <eos>	like ( eliza , tracy ) <eos>	like ( eliza , tracy ) <eos> walk walk walk walk walk walk walk walk walk walk walk walk walk walk walk walk walk walk walk walk walk walk walk
francis meets zelda <eos>	meet ( francis , zelda ) <eos>	meet ( francis , zelda ) <eos> walk walk walk walk walk walk walk walk walk walk walk walk walk walk walk walk walk walk walk walk walk walk walk
francis sees katherine <eos>	see ( francis , katherine ) <eos>	see ( francis , katherine ) <eos> walk walk walk walk walk walk walk walk walk walk walk walk walk walk walk walk walk walk walk walk walk walk walk
francis sees bob <eos>	see ( francis , bob ) <eos>	see ( francis , bob ) <eos> walk walk walk walk walk walk walk walk walk walk walk walk walk walk walk walk walk walk walk walk walk walk walk
eliza knows lewis <eos>	know ( eliza , lewis ) <eos>	know ( eliza , lewis ) <eos> walk walk walk walk walk walk walk walk walk walk walk walk walk walk walk walk walk walk walk walk walk walk walk
eliza knows francis <eos>	know ( eliza , francis ) <eos>	know ( eliza , francis ) <eos> walk walk walk walk walk walk walk walk walk walk walk walk walk walk walk walk walk walk walk walk walk walk walk
francis dislikes katherine <eos>	dislike ( francis , katherine ) <eos>	dislike ( francis , katherine ) <eos> walk walk walk walk walk walk walk walk walk walk walk walk walk walk walk walk walk walk walk walk walk walk walk
francis dislikes alice <eos>	dislike ( francis , alice ) <eos>	dislike ( francis , alice ) <eos> walk walk walk walk walk walk walk walk walk walk walk walk walk walk walk walk walk walk walk walk walk walk walk
francis likes yvette <eos>	like ( francis , yvettte ) <eos>	like ( francis , yvettte ) <eos> walk walk walk walk walk walk walk walk walk walk walk walk walk walk walk walk walk walk walk walk walk walk walk
francis likes tracy <eos>	like ( francis , tracy ) <eos>	like ( francis , tracy ) <eos> walk walk walk walk walk walk walk walk walk walk walk walk walk walk walk walk walk walk walk walk walk walk walk
francis likes john <eos>	like ( francis , john ) <eos>	like ( francis , john ) <eos> walk walk walk walk walk walk walk walk walk walk walk walk walk walk walk walk walk walk walk walk walk walk walk
francis notices zelda <eos>	notice ( francis , zelda ) <eos>	notice ( francis , zelda ) <eos> walk walk walk walk walk walk walk walk walk walk walk walk walk walk walk walk walk walk walk walk walk walk walk
francis notices bob <eos>	notice ( francis , bob ) <eos>	notice ( francis , bob ) <eos> walk walk walk walk walk walk walk walk walk walk walk walk walk walk walk walk walk walk walk walk walk walk walk
francis throws lewis <eos>	throw ( francis , lewis ) <eos>	throw ( francis , lewis ) <eos> walk walk walk walk walk walk walk walk walk walk walk walk walk walk walk walk walk walk walk walk walk walk walk
francis throws claire <eos>	throw ( francis , claire ) <eos>	throw ( francis , claire ) <eos> walk walk walk walk walk walk walk walk walk walk walk walk walk walk walk walk walk walk walk walk walk walk walk
francis dislikes ursula <eos>	dislike ( francis , ursula ) <eos>	dislike ( francis , ursula ) <eos> walk walk walk walk walk walk walk walk walk walk walk walk walk walk walk walk walk walk walk walk walk walk walk
francis knows ursula <eos>	know ( francis , ursula ) <eos>	know ( francis , ursula ) <eos> walk walk walk walk walk walk walk walk walk walk walk walk walk walk walk walk walk walk walk walk walk walk walk
francis knows samuel <eos>	know ( francis , samuel ) <eos>	know ( francis , samuel ) <eos> walk walk walk walk walk walk walk walk walk walk walk walk walk walk walk walk walk walk walk walk walk walk walk
francis knows oswald <eos>	know ( francis , oswald ) <eos>	know ( francis , oswald ) <eos> walk walk walk walk walk walk walk walk walk walk walk walk walk walk walk walk walk walk walk walk walk walk walk
francis knows john <eos>	know ( francis , john ) <eos>	know ( francis , john ) <eos> walk walk walk walk walk walk walk walk walk walk walk walk walk walk walk walk walk walk walk walk walk walk walk
francis knows claire <eos>	know ( francis , claire ) <eos>	know ( francis , claire ) <eos> walk walk walk walk walk walk walk walk walk walk walk walk walk walk walk walk walk walk walk walk walk walk walk
grace sees quinn <eos>	see ( grace , quinn ) <eos>	see ( grace , quinn ) <eos> walk walk walk walk walk walk walk walk walk walk walk walk walk walk walk walk walk walk walk walk walk walk walk
grace sees neha <eos>	see ( grace , neha ) <eos>	see ( grace , neha ) <eos> walk walk walk walk walk walk walk walk walk walk walk walk walk walk walk walk walk walk walk walk walk walk walk
francis sees himself <eos>	see ( francis , francis ) <eos>	see ( francis , francis ) <eos> walk walk walk walk walk walk walk walk walk walk walk walk walk walk walk walk walk walk walk walk walk walk walk
francis knows zelda <eos>	know ( francis , zelda ) <eos>	know ( francis , zelda ) <eos> walk walk walk walk walk walk walk walk walk walk walk walk walk walk walk walk walk walk walk walk walk walk walk
francis knows xerxes <eos>	know ( francis , xerxes ) <eos>	know ( francis , xerxes ) <eos> walk walk walk walk walk walk walk walk walk walk walk walk walk walk walk walk walk walk walk walk walk walk walk
grace likes quinn <eos>	like ( grace , quinn ) <eos>	like ( grace , quinn ) <eos> walk walk walk walk walk walk walk walk walk walk walk walk walk walk walk walk walk walk walk walk walk walk walk
grace meets margaret <eos>	meet ( grace , margaret ) <eos>	meet ( grace , margaret ) <eos> walk walk walk walk walk walk walk walk walk walk walk walk walk walk walk walk walk walk walk walk walk walk walk
grace meets isla <eos>	meet ( grace , isla ) <eos>	meet ( grace , isla ) <eos> walk walk walk walk walk walk walk walk walk walk walk walk walk walk walk walk walk walk walk walk walk walk walk
grace meets alice <eos>	meet ( grace , alice ) <eos>	meet ( grace , alice ) <eos> walk walk walk walk walk walk walk walk walk walk walk walk walk walk walk walk walk walk walk walk walk walk walk
grace sees ursula <eos>	see ( grace , ursula ) <eos>	see ( grace , ursula ) <eos> walk walk walk walk walk walk walk walk walk walk walk walk walk walk walk walk walk walk walk walk walk walk walk
grace dislikes winnifred <eos>	dislike ( grace , winnifred ) <eos>	dislike ( grace , winnifred ) <eos> walk walk walk walk walk walk walk walk walk walk walk walk walk walk walk walk walk walk walk walk walk walk walk
grace dislikes tracy <eos>	dislike ( grace , tracy ) <eos>	dislike ( grace , tracy ) <eos> walk walk walk walk walk walk walk walk walk walk walk walk walk walk walk walk walk walk walk walk walk walk walk
grace dislikes isla <eos>	dislike ( grace , isla ) <eos>	dislike ( grace , isla ) <eos> walk walk walk walk walk walk walk walk walk walk walk walk walk walk walk walk walk walk walk walk walk walk walk
grace dislikes eliza <eos>	dislike ( grace , eliza ) <eos>	dislike ( grace , eliza ) <eos> walk walk walk walk walk walk walk walk walk walk walk walk walk walk walk walk walk walk walk walk walk walk walk
grace likes rachael <eos>	like ( grace , rachael ) <eos>	like ( grace , rachael ) <eos> walk walk walk walk walk walk walk walk walk walk walk walk walk walk walk walk walk walk walk walk walk walk walk
grace knows ursula <eos>	know ( grace , ursula ) <eos>	know ( grace , ursula ) <eos> walk walk walk walk walk walk walk walk walk walk walk walk walk walk walk walk walk walk walk walk walk walk walk
grace knows tracy <eos>	know ( grace , tracy ) <eos>	know ( grace , tracy ) <eos> walk walk walk walk walk walk walk walk walk walk walk walk walk walk walk walk walk walk walk walk walk walk walk
grace notices tracy <eos>	notice ( grace , tracy ) <eos>	notice ( grace , tracy ) <eos> walk walk walk walk walk walk walk walk walk walk walk walk walk walk walk walk walk walk walk walk walk walk walk
grace notices lewis <eos>	notice ( grace , lewis ) <eos>	notice ( grace , lewis ) <eos> walk walk walk walk walk walk walk walk walk walk walk walk walk walk walk walk walk walk walk walk walk walk walk
grace throws katherine <eos>	throw ( grace , katherine ) <eos>	throw ( grace , katherine ) <eos> walk walk walk walk walk walk walk walk walk walk walk walk walk walk walk walk walk walk walk walk walk walk walk
henry sees zelda <eos>	see ( henry , zelda ) <eos>	see ( henry , zelda ) <eos> walk walk walk walk walk walk walk walk walk walk walk walk walk walk walk walk walk walk walk walk walk walk walk
henry sees quinn <eos>	see ( henry , quinn ) <eos>	see ( henry , quinn ) <eos> walk walk walk walk walk walk walk walk walk walk walk walk walk walk walk walk walk walk walk walk walk walk walk
henry sees patricia <eos>	see ( henry , patricia ) <eos>	see ( henry , patricia ) <eos> walk walk walk walk walk walk walk walk walk walk walk walk walk walk walk walk walk walk walk walk walk walk walk
henry sees john <eos>	see ( henry , john ) <eos>	see ( henry , john ) <eos> walk walk walk walk walk walk walk walk walk walk walk walk walk walk walk walk walk walk walk walk walk walk walk
henry sees alice <eos>	see ( henry , alice ) <eos>	see ( henry , alice ) <eos> walk walk walk walk walk walk walk walk walk walk walk walk walk walk walk walk walk walk walk walk walk walk walk
henry dislikes neha <eos>	dislike ( henry , neha ) <eos>	dislike ( henry , neha ) <eos> walk walk walk walk walk walk walk walk walk walk walk walk walk walk walk walk walk walk walk walk walk walk walk
henry dislikes lewis <eos>	dislike ( henry , lewis ) <eos>	dislike ( henry , lewis ) <eos> walk walk walk walk walk walk walk walk walk walk walk walk walk walk walk walk walk walk walk walk walk walk walk
henry likes rachael <eos>	like ( henry , rachael ) <eos>	like ( henry , rachael ) <eos> walk walk walk walk walk walk walk walk walk walk walk walk walk walk walk walk walk walk walk walk walk walk walk
henry meets oswald <eos>	meet ( henry , oswald ) <eos>	meet ( henry , oswald ) <eos> walk walk walk walk walk walk walk walk walk walk walk walk walk walk walk walk walk walk walk walk walk walk walk
henry meets alice <eos>	meet ( henry , alice ) <eos>	meet ( henry , alice ) <eos> walk walk walk walk walk walk walk walk walk walk walk walk walk walk walk walk walk walk walk walk walk walk walk
henry knows winnifred <eos>	know ( henry , winnifred ) <eos>	know ( henry , winnifred ) <eos> walk walk walk walk walk walk walk walk walk walk walk walk walk walk walk walk walk walk walk walk walk walk walk
henry knows isla <eos>	know ( henry , isla ) <eos>	know ( henry , isla ) <eos> walk walk walk walk walk walk walk walk walk walk walk walk walk walk walk walk walk walk walk walk walk walk walk
henry notices xerxes <eos>	notice ( henry , xerxes ) <eos>	notice ( henry , xerxes ) <eos> walk walk walk walk walk walk walk walk walk walk walk walk walk walk walk walk walk walk walk walk walk walk walk
henry throws john <eos>	throw ( henry , john ) <eos>	throw ( henry , john ) <eos> walk walk walk walk walk walk walk walk walk walk walk walk walk walk walk walk walk walk walk walk walk walk walk
henry throws claire <eos>	throw ( henry , claire ) <eos>	throw ( henry , claire ) <eos> walk walk walk walk walk walk walk walk walk walk walk walk walk walk walk walk walk walk walk walk walk walk walk
isla sees rachael <eos>	see ( isla , rachael ) <eos>	see ( isla , rachael ) <eos> walk walk walk walk walk walk walk walk walk walk walk walk walk walk walk walk walk walk walk walk walk walk walk
isla sees patricia <eos>	see ( isla , patricia ) <eos>	see ( isla , patricia ) <eos> walk walk walk walk walk walk walk walk walk walk walk walk walk walk walk walk walk walk walk walk walk walk walk
isla sees neha <eos>	see ( isla , neha ) <eos>	see ( isla , neha ) <eos> walk walk walk walk walk walk walk walk walk walk walk walk walk walk walk walk walk walk walk walk walk walk walk
henry notices himself <eos>	notice ( henry , henry ) <eos>	notice ( henry , henry ) <eos> walk walk walk walk walk walk walk walk walk walk walk walk walk walk walk walk walk walk walk walk walk walk walk
henry meets himself <eos>	meet ( henry , henry ) <eos>	meet ( henry , henry ) <eos> walk walk walk walk walk walk walk walk walk walk walk walk walk walk walk walk walk walk walk walk walk walk walk
isla meets katherine <eos>	meet ( isla , katherine ) <eos>	meet ( isla , katherine ) <eos> walk walk walk walk walk walk walk walk walk walk walk walk walk walk walk walk walk walk walk walk walk walk walk
isla meets henry <eos>	meet ( isla , henry ) <eos>	meet ( isla , henry ) <eos> walk walk walk walk walk walk walk walk walk walk walk walk walk walk walk walk walk walk walk walk walk walk walk
isla sees yvette <eos>	see ( isla , yvettte ) <eos>	see ( isla , yvettte ) <eos> walk walk walk walk walk walk walk walk walk walk walk walk walk walk walk walk walk walk walk walk walk walk walk
isla sees ursula <eos>	see ( isla , ursula ) <eos>	see ( isla , ursula ) <eos> walk walk walk walk walk walk walk walk walk walk walk walk walk walk walk walk walk walk walk walk walk walk walk
isla sees samuel <eos>	see ( isla , samuel ) <eos>	see ( isla , samuel ) <eos> walk walk walk walk walk walk walk walk walk walk walk walk walk walk walk walk walk walk walk walk walk walk walk
isla likes rachael <eos>	like ( isla , rachael ) <eos>	like ( isla , rachael ) <eos> walk walk walk walk walk walk walk walk walk walk walk walk walk walk walk walk walk walk walk walk walk walk walk
isla likes isla <eos>	like ( isla , isla ) <eos>	like ( isla , isla ) <eos> walk walk walk walk walk walk walk walk walk walk walk walk walk walk walk walk walk walk walk walk walk walk walk
isla likes henry <eos>	like ( isla , henry ) <eos>	like ( isla , henry ) <eos> walk walk walk walk walk walk walk walk walk walk walk walk walk walk walk walk walk walk walk walk walk walk walk
isla likes claire <eos>	like ( isla , claire ) <eos>	like ( isla , claire ) <eos> walk walk walk walk walk walk walk walk walk walk walk walk walk walk walk walk walk walk walk walk walk walk walk
isla meets zelda <eos>	meet ( isla , zelda ) <eos>	meet ( isla , zelda ) <eos> walk walk walk walk walk walk walk walk walk walk walk walk walk walk walk walk walk walk walk walk walk walk walk
isla throws lewis <eos>	throw ( isla , lewis ) <eos>	throw ( isla , lewis ) <eos> walk walk walk walk walk walk walk walk walk walk walk walk walk walk walk walk walk walk walk walk walk walk walk
isla throws henry <eos>	throw ( isla , henry ) <eos>	throw ( isla , henry ) <eos> walk walk walk walk walk walk walk walk walk walk walk walk walk walk walk walk walk walk walk walk walk walk walk
isla dislikes xerxes <eos>	dislike ( isla , xerxes ) <eos>	dislike ( isla , xerxes ) <eos> walk walk walk walk walk walk walk walk walk walk walk walk walk walk walk walk walk walk walk walk walk walk walk
isla dislikes patricia <eos>	dislike ( isla , patricia ) <eos>	dislike ( isla , patricia ) <eos> walk walk walk walk walk walk walk walk walk walk walk walk walk walk walk walk walk walk walk walk walk walk walk
isla dislikes daniel <eos>	dislike ( isla , daniel ) <eos>	dislike ( isla , daniel ) <eos> walk walk walk walk walk walk walk walk walk walk walk walk walk walk walk walk walk walk walk walk walk walk walk
isla knows henry <eos>	know ( isla , henry ) <eos>	know ( isla , henry ) <eos> walk walk walk walk walk walk walk walk walk walk walk walk walk walk walk walk walk walk walk walk walk walk walk
isla knows francis <eos>	know ( isla , francis ) <eos>	know ( isla , francis ) <eos> walk walk walk walk walk walk walk walk walk walk walk walk walk walk walk walk walk walk walk walk walk walk walk
isla notices zelda <eos>	notice ( isla , zelda ) <eos>	notice ( isla , zelda ) <eos> walk walk walk walk walk walk walk walk walk walk walk walk walk walk walk walk walk walk walk walk walk walk walk
isla notices rachael <eos>	notice ( isla , rachael ) <eos>	notice ( isla , rachael ) <eos> walk walk walk walk walk walk walk walk walk walk walk walk walk walk walk walk walk walk walk walk walk walk walk
isla notices henry <eos>	notice ( isla , henry ) <eos>	notice ( isla , henry ) <eos> walk walk walk walk walk walk walk walk walk walk walk walk walk walk walk walk walk walk walk walk walk walk walk
john likes tracy <eos>	like ( john , tracy ) <eos>	like ( john , tracy ) <eos> walk walk walk walk walk walk walk walk walk walk walk walk walk walk walk walk walk walk walk walk walk walk walk
john likes quinn <eos>	like ( john , quinn ) <eos>	like ( john , quinn ) <eos> walk walk walk walk walk walk walk walk walk walk walk walk walk walk walk walk walk walk walk walk walk walk walk
john likes lewis <eos>	like ( john , lewis ) <eos>	like ( john , lewis ) <eos> walk walk walk walk walk walk walk walk walk walk walk walk walk walk walk walk walk walk walk walk walk walk walk
john likes daniel <eos>	like ( john , daniel ) <eos>	like ( john , daniel ) <eos> walk walk walk walk walk walk walk walk walk walk walk walk walk walk walk walk walk walk walk walk walk walk walk
isla knows patricia <eos>	know ( isla , patricia ) <eos>	know ( isla , patricia ) <eos> walk walk walk walk walk walk walk walk walk walk walk walk walk walk walk walk walk walk walk walk walk walk walk
john throws bob <eos>	throw ( john , bob ) <eos>	throw ( john , bob ) <eos> walk walk walk walk walk walk walk walk walk walk walk walk walk walk walk walk walk walk walk walk walk walk walk
john dislikes zelda <eos>	dislike ( john , zelda ) <eos>	dislike ( john , zelda ) <eos> walk walk walk walk walk walk walk walk walk walk walk walk walk walk walk walk walk walk walk walk walk walk walk
john dislikes neha <eos>	dislike ( john , neha ) <eos>	dislike ( john , neha ) <eos> walk walk walk walk walk walk walk walk walk walk walk walk walk walk walk walk walk walk walk walk walk walk walk
john dislikes henry <eos>	dislike ( john , henry ) <eos>	dislike ( john , henry ) <eos> walk walk walk walk walk walk walk walk walk walk walk walk walk walk walk walk walk walk walk walk walk walk walk
john dislikes claire <eos>	dislike ( john , claire ) <eos>	dislike ( john , claire ) <eos> walk walk walk walk walk walk walk walk walk walk walk walk walk walk walk walk walk walk walk walk walk walk walk
john knows eliza <eos>	know ( john , eliza ) <eos>	know ( john , eliza ) <eos> walk walk walk walk walk walk walk walk walk walk walk walk walk walk walk walk walk walk walk walk walk walk walk
john notices patricia <eos>	notice ( john , patricia ) <eos>	notice ( john , patricia ) <eos> walk walk walk walk walk walk walk walk walk walk walk walk walk walk walk walk walk walk walk walk walk walk walk
john throws winnifred <eos>	throw ( john , winnifred ) <eos>	throw ( john , winnifred ) <eos> walk walk walk walk walk walk walk walk walk walk walk walk walk walk walk walk walk walk walk walk walk walk walk
john throws oswald <eos>	throw ( john , oswald ) <eos>	throw ( john , oswald ) <eos> walk walk walk walk walk walk walk walk walk walk walk walk walk walk walk walk walk walk walk walk walk walk walk
john throws daniel <eos>	throw ( john , daniel ) <eos>	throw ( john , daniel ) <eos> walk walk walk walk walk walk walk walk walk walk walk walk walk walk walk walk walk walk walk walk walk walk walk
katherine sees daniel <eos>	see ( katherine , daniel ) <eos>	see ( katherine , daniel ) <eos> walk walk walk walk walk walk walk walk walk walk walk walk walk walk walk walk walk walk walk walk walk walk walk
john notices himself <eos>	notice ( john , john ) <eos>	notice ( john , john ) <eos> walk walk walk walk walk walk walk walk walk walk walk walk walk walk walk walk walk walk walk walk walk walk walk
john likes himself <eos>	like ( john , john ) <eos>	like ( john , john ) <eos> walk walk walk walk walk walk walk walk walk walk walk walk walk walk walk walk walk walk walk walk walk walk walk
john meets himself <eos>	meet ( john , john ) <eos>	meet ( john , alice ) <eos> walk walk walk walk walk walk walk walk walk walk walk walk walk walk walk walk walk walk walk walk walk walk walk
john knows victor <eos>	know ( john , victor ) <eos>	know ( john , victor ) <eos> walk walk walk walk walk walk walk walk walk walk walk walk walk walk walk walk walk walk walk walk walk walk walk
katherine meets yvette <eos>	meet ( katherine , yvettte ) <eos>	meet ( katherine , yvettte ) <eos> walk walk walk walk walk walk walk walk walk walk walk walk walk walk walk walk walk walk walk walk walk walk walk
katherine meets tracy <eos>	meet ( katherine , tracy ) <eos>	meet ( katherine , tracy ) <eos> walk walk walk walk walk walk walk walk walk walk walk walk walk walk walk walk walk walk walk walk walk walk walk
katherine meets claire <eos>	meet ( katherine , claire ) <eos>	meet ( katherine , claire ) <eos> walk walk walk walk walk walk walk walk walk walk walk walk walk walk walk walk walk walk walk walk walk walk walk
katherine sees oswald <eos>	see ( katherine , oswald ) <eos>	see ( katherine , oswald ) <eos> walk walk walk walk walk walk walk walk walk walk walk walk walk walk walk walk walk walk walk walk walk walk walk
katherine sees katherine <eos>	see ( katherine , katherine ) <eos>	see ( katherine , katherine ) <eos> walk walk walk walk walk walk walk walk walk walk walk walk walk walk walk walk walk walk walk walk walk walk walk
katherine throws alice <eos>	throw ( katherine , alice ) <eos>	throw ( katherine , alice ) <eos> walk walk walk walk walk walk walk walk walk walk walk walk walk walk walk walk walk walk walk walk walk walk walk
katherine dislikes quinn <eos>	dislike ( katherine , quinn ) <eos>	dislike ( katherine , quinn ) <eos> walk walk walk walk walk walk walk walk walk walk walk walk walk walk walk walk walk walk walk walk walk walk walk
katherine dislikes eliza <eos>	dislike ( katherine , eliza ) <eos>	dislike ( katherine , eliza ) <eos> walk walk walk walk walk walk walk walk walk walk walk walk walk walk walk walk walk walk walk walk walk walk walk
katherine dislikes bob <eos>	dislike ( katherine , bob ) <eos>	dislike ( katherine , bob ) <eos> walk walk walk walk walk walk walk walk walk walk walk walk walk walk walk walk walk walk walk walk walk walk walk
katherine likes rachael <eos>	like ( katherine , rachael ) <eos>	like ( katherine , rachael ) <eos> walk walk walk walk walk walk walk walk walk walk walk walk walk walk walk walk walk walk walk walk walk walk walk
katherine notices margaret <eos>	notice ( katherine , margaret ) <eos>	notice ( katherine , margaret ) <eos> walk walk walk walk walk walk walk walk walk walk walk walk walk walk walk walk walk walk walk walk walk walk walk
katherine notices francis <eos>	notice ( katherine , francis ) <eos>	notice ( katherine , francis ) <eos> walk walk walk walk walk walk walk walk walk walk walk walk walk walk walk walk walk walk walk walk walk walk walk
katherine throws tracy <eos>	throw ( katherine , tracy ) <eos>	throw ( katherine , tracy ) <eos> walk walk walk walk walk walk walk walk walk walk walk walk walk walk walk walk walk walk walk walk walk walk walk
katherine throws francis <eos>	throw ( katherine , francis ) <eos>	throw ( katherine , francis ) <eos> walk walk walk walk walk walk walk walk walk walk walk walk walk walk walk walk walk walk walk walk walk walk walk
katherine throws claire <eos>	throw ( katherine , claire ) <eos>	throw ( katherine , claire ) <eos> walk walk walk walk walk walk walk walk walk walk walk walk walk walk walk walk walk walk walk walk walk walk walk
katherine dislikes herself <eos>	dislike ( katherine , katherine ) <eos>	dislike ( katherine , katherine ) <eos> walk walk walk walk walk walk walk walk walk walk walk walk walk walk walk walk walk walk walk walk walk walk walk
katherine knows rachael <eos>	know ( katherine , rachael ) <eos>	know ( katherine , rachael ) <eos> walk walk walk walk walk walk walk walk walk walk walk walk walk walk walk walk walk walk walk walk walk walk walk
katherine knows isla <eos>	know ( katherine , isla ) <eos>	know ( katherine , isla ) <eos> walk walk walk walk walk walk walk walk walk walk walk walk walk walk walk walk walk walk walk walk walk walk walk
katherine knows francis <eos>	know ( katherine , francis ) <eos>	know ( katherine , francis ) <eos> walk walk walk walk walk walk walk walk walk walk walk walk walk walk walk walk walk walk walk walk walk walk walk
katherine notices neha <eos>	notice ( katherine , neha ) <eos>	notice ( katherine , neha ) <eos> walk walk walk walk walk walk walk walk walk walk walk walk walk walk walk walk walk walk walk walk walk walk walk
lewis likes bob <eos>	like ( lewis , bob ) <eos>	like ( lewis , bob ) <eos> walk walk walk walk walk walk walk walk walk walk walk walk walk walk walk walk walk walk walk walk walk walk walk
lewis meets ursula <eos>	meet ( lewis , ursula ) <eos>	meet ( lewis , ursula ) <eos> walk walk walk walk walk walk walk walk walk walk walk walk walk walk walk walk walk walk walk walk walk walk walk
lewis meets grace <eos>	meet ( lewis , grace ) <eos>	meet ( lewis , grace ) <eos> walk walk walk walk walk walk walk walk walk walk walk walk walk walk walk walk walk walk walk walk walk walk walk
lewis sees xerxes <eos>	see ( lewis , xerxes ) <eos>	see ( lewis , xerxes ) <eos> walk walk walk walk walk walk walk walk walk walk walk walk walk walk walk walk walk walk walk walk walk walk walk
lewis sees katherine <eos>	see ( lewis , katherine ) <eos>	see ( lewis , katherine ) <eos> walk walk walk walk walk walk walk walk walk walk walk walk walk walk walk walk walk walk walk walk walk walk walk
lewis throws isla <eos>	throw ( lewis , isla ) <eos>	throw ( lewis , isla ) <eos> walk walk walk walk walk walk walk walk walk walk walk walk walk walk walk walk walk walk walk walk walk walk walk
lewis throws alice <eos>	throw ( lewis , alice ) <eos>	throw ( lewis , alice ) <eos> walk walk walk walk walk walk walk walk walk walk walk walk walk walk walk walk walk walk walk walk walk walk walk
lewis dislikes neha <eos>	dislike ( lewis , neha ) <eos>	dislike ( lewis , neha ) <eos> walk walk walk walk walk walk walk walk walk walk walk walk walk walk walk walk walk walk walk walk walk walk walk
lewis likes victor <eos>	like ( lewis , victor ) <eos>	like ( lewis , victor ) <eos> walk walk walk walk walk walk walk walk walk walk walk walk walk walk walk walk walk walk walk walk walk walk walk
lewis likes ursula <eos>	like ( lewis , ursula ) <eos>	like ( lewis , ursula ) <eos> walk walk walk walk walk walk walk walk walk walk walk walk walk walk walk walk walk walk walk walk walk walk walk
lewis knows quinn <eos>	know ( lewis , quinn ) <eos>	know ( lewis , quinn ) <eos> walk walk walk walk walk walk walk walk walk walk walk walk walk walk walk walk walk walk walk walk walk walk walk
lewis knows john <eos>	know ( lewis , john ) <eos>	know ( lewis , john ) <eos> walk walk walk walk walk walk walk walk walk walk walk walk walk walk walk walk walk walk walk walk walk walk walk
lewis notices rachael <eos>	notice ( lewis , rachael ) <eos>	notice ( lewis , rachael ) <eos> walk walk walk walk walk walk walk walk walk walk walk walk walk walk walk walk walk walk walk walk walk walk walk
lewis throws ursula <eos>	throw ( lewis , ursula ) <eos>	throw ( lewis , ursula ) <eos> walk walk walk walk walk walk walk walk walk walk walk walk walk walk walk walk walk walk walk walk walk walk walk
lewis throws margaret <eos>	throw ( lewis , margaret ) <eos>	throw ( lewis , margaret ) <eos> walk walk walk walk walk walk walk walk walk walk walk walk walk walk walk walk walk walk walk walk walk walk walk
margaret likes claire <eos>	like ( margaret , claire ) <eos>	like ( margaret , claire ) <eos> walk walk walk walk walk walk walk walk walk walk walk walk walk walk walk walk walk walk walk walk walk walk walk
margaret meets quinn <eos>	meet ( margaret , quinn ) <eos>	meet ( margaret , quinn ) <eos> walk walk walk walk walk walk walk walk walk walk walk walk walk walk walk walk walk walk walk walk walk walk walk
margaret meets isla <eos>	meet ( margaret , isla ) <eos>	meet ( margaret , isla ) <eos> walk walk walk walk walk walk walk walk walk walk walk walk walk walk walk walk walk walk walk walk walk walk walk
lewis knows himself <eos>	know ( lewis , lewis ) <eos>	know ( lewis , lewis ) <eos> walk walk walk walk walk walk walk walk walk walk walk walk walk walk walk walk walk walk walk walk walk walk walk
lewis knows victor <eos>	know ( lewis , victor ) <eos>	know ( lewis , victor ) <eos> walk walk walk walk walk walk walk walk walk walk walk walk walk walk walk walk walk walk walk walk walk walk walk
margaret notices daniel <eos>	notice ( margaret , daniel ) <eos>	notice ( margaret , daniel ) <eos> walk walk walk walk walk walk walk walk walk walk walk walk walk walk walk walk walk walk walk walk walk walk walk
margaret throws margaret <eos>	throw ( margaret , margaret ) <eos>	throw ( margaret , margaret ) <eos> walk walk walk walk walk walk walk walk walk walk walk walk walk walk walk walk walk walk walk walk walk walk walk
margaret throws claire <eos>	throw ( margaret , claire ) <eos>	throw ( margaret , claire ) <eos> walk walk walk walk walk walk walk walk walk walk walk walk walk walk walk walk walk walk walk walk walk walk walk
margaret dislikes zelda <eos>	dislike ( margaret , zelda ) <eos>	dislike ( margaret , zelda ) <eos> walk walk walk walk walk walk walk walk walk walk walk walk walk walk walk walk walk walk walk walk walk walk walk
margaret dislikes winnifred <eos>	dislike ( margaret , winnifred ) <eos>	dislike ( margaret , winnifred ) <eos> walk walk walk walk walk walk walk walk walk walk walk walk walk walk walk walk walk walk walk walk walk walk walk
neha sees oswald <eos>	see ( neha , oswald ) <eos>	see ( neha , oswald ) <eos> walk walk walk walk walk walk walk walk walk walk walk walk walk walk walk walk walk walk walk walk walk walk walk
neha sees daniel <eos>	see ( neha , daniel ) <eos>	see ( neha , daniel ) <eos> walk walk walk walk walk walk walk walk walk walk walk walk walk walk walk walk walk walk walk walk walk walk walk
margaret sees herself <eos>	see ( margaret , margaret ) <eos>	see ( margaret , margaret ) <eos> walk walk walk walk walk walk walk walk walk walk walk walk walk walk walk walk walk walk walk walk walk walk walk
margaret knows daniel <eos>	know ( margaret , daniel ) <eos>	know ( margaret , daniel ) <eos> walk walk walk walk walk walk walk walk walk walk walk walk walk walk walk walk walk walk walk walk walk walk walk
margaret notices lewis <eos>	notice ( margaret , lewis ) <eos>	notice ( margaret , lewis ) <eos> walk walk walk walk walk walk walk walk walk walk walk walk walk walk walk walk walk walk walk walk walk walk walk
neha likes ursula <eos>	like ( neha , ursula ) <eos>	like ( neha , ursula ) <eos> walk walk walk walk walk walk walk walk walk walk walk walk walk walk walk walk walk walk walk walk walk walk walk
neha likes eliza <eos>	like ( neha , eliza ) <eos>	like ( neha , eliza ) <eos> walk walk walk walk walk walk walk walk walk walk walk walk walk walk walk walk walk walk walk walk walk walk walk
neha meets rachael <eos>	meet ( neha , rachael ) <eos>	meet ( neha , rachael ) <eos> walk walk walk walk walk walk walk walk walk walk walk walk walk walk walk walk walk walk walk walk walk walk walk
neha sees tracy <eos>	see ( neha , tracy ) <eos>	see ( neha , tracy ) <eos> walk walk walk walk walk walk walk walk walk walk walk walk walk walk walk walk walk walk walk walk walk walk walk
neha sees quinn <eos>	see ( neha , quinn ) <eos>	see ( neha , quinn ) <eos> walk walk walk walk walk walk walk walk walk walk walk walk walk walk walk walk walk walk walk walk walk walk walk
neha dislikes zelda <eos>	dislike ( neha , zelda ) <eos>	dislike ( neha , zelda ) <eos> walk walk walk walk walk walk walk walk walk walk walk walk walk walk walk walk walk walk walk walk walk walk walk
neha dislikes ursula <eos>	dislike ( neha , ursula ) <eos>	dislike ( neha , ursula ) <eos> walk walk walk walk walk walk walk walk walk walk walk walk walk walk walk walk walk walk walk walk walk walk walk
neha dislikes henry <eos>	dislike ( neha , henry ) <eos>	dislike ( neha , henry ) <eos> walk walk walk walk walk walk walk walk walk walk walk walk walk walk walk walk walk walk walk walk walk walk walk
neha dislikes grace <eos>	dislike ( neha , grace ) <eos>	dislike ( neha , grace ) <eos> walk walk walk walk walk walk walk walk walk walk walk walk walk walk walk walk walk walk walk walk walk walk walk
neha dislikes daniel <eos>	dislike ( neha , daniel ) <eos>	dislike ( neha , daniel ) <eos> walk walk walk walk walk walk walk walk walk walk walk walk walk walk walk walk walk walk walk walk walk walk walk
neha notices rachael <eos>	notice ( neha , rachael ) <eos>	notice ( neha , rachael ) <eos> walk walk walk walk walk walk walk walk walk walk walk walk walk walk walk walk walk walk walk walk walk walk walk
neha throws ursula <eos>	throw ( neha , ursula ) <eos>	throw ( neha , ursula ) <eos> walk walk walk walk walk walk walk walk walk walk walk walk walk walk walk walk walk walk walk walk walk walk walk
neha throws oswald <eos>	throw ( neha , oswald ) <eos>	throw ( neha , oswald ) <eos> walk walk walk walk walk walk walk walk walk walk walk walk walk walk walk walk walk walk walk walk walk walk walk
neha throws margaret <eos>	throw ( neha , margaret ) <eos>	throw ( neha , margaret ) <eos> walk walk walk walk walk walk walk walk walk walk walk walk walk walk walk walk walk walk walk walk walk walk walk
neha throws lewis <eos>	throw ( neha , lewis ) <eos>	throw ( neha , lewis ) <eos> walk walk walk walk walk walk walk walk walk walk walk walk walk walk walk walk walk walk walk walk walk walk walk
oswald sees francis <eos>	see ( oswald , francis ) <eos>	see ( oswald , francis ) <eos> walk walk walk walk walk walk walk walk walk walk walk walk walk walk walk walk walk walk walk walk walk walk walk
oswald sees bob <eos>	see ( oswald , bob ) <eos>	see ( oswald , bob ) <eos> walk walk walk walk walk walk walk walk walk walk walk walk walk walk walk walk walk walk walk walk walk walk walk
neha knows yvette <eos>	know ( neha , yvettte ) <eos>	know ( neha , yvettte ) <eos> walk walk walk walk walk walk walk walk walk walk walk walk walk walk walk walk walk walk walk walk walk walk walk
neha knows xerxes <eos>	know ( neha , xerxes ) <eos>	know ( neha , xerxes ) <eos> walk walk walk walk walk walk walk walk walk walk walk walk walk walk walk walk walk walk walk walk walk walk walk
neha knows oswald <eos>	know ( neha , oswald ) <eos>	know ( neha , oswald ) <eos> walk walk walk walk walk walk walk walk walk walk walk walk walk walk walk walk walk walk walk walk walk walk walk
oswald likes isla <eos>	like ( oswald , isla ) <eos>	like ( oswald , isla ) <eos> walk walk walk walk walk walk walk walk walk walk walk walk walk walk walk walk walk walk walk walk walk walk walk
oswald meets john <eos>	meet ( oswald , john ) <eos>	meet ( oswald , john ) <eos> walk walk walk walk walk walk walk walk walk walk walk walk walk walk walk walk walk walk walk walk walk walk walk
oswald sees tracy <eos>	see ( oswald , tracy ) <eos>	see ( oswald , tracy ) <eos> walk walk walk walk walk walk walk walk walk walk walk walk walk walk walk walk walk walk walk walk walk walk walk
oswald sees quinn <eos>	see ( oswald , quinn ) <eos>	see ( oswald , quinn ) <eos> walk walk walk walk walk walk walk walk walk walk walk walk walk walk walk walk walk walk walk walk walk walk walk
oswald sees neha <eos>	see ( oswald , neha ) <eos>	see ( oswald , neha ) <eos> walk walk walk walk walk walk walk walk walk walk walk walk walk walk walk walk walk walk walk walk walk walk walk
oswald throws john <eos>	throw ( oswald , john ) <eos>	throw ( oswald , john ) <eos> walk walk walk walk walk walk walk walk walk walk walk walk walk walk walk walk walk walk walk walk walk walk walk
oswald dislikes yvette <eos>	dislike ( oswald , yvettte ) <eos>	dislike ( oswald , yvettte ) <eos> walk walk walk walk walk walk walk walk walk walk walk walk walk walk walk walk walk walk walk walk walk walk walk
oswald dislikes lewis <eos>	dislike ( oswald , lewis ) <eos>	dislike ( oswald , lewis ) <eos> walk walk walk walk walk walk walk walk walk walk walk walk walk walk walk walk walk walk walk walk walk walk walk
oswald likes yvette <eos>	like ( oswald , yvettte ) <eos>	like ( oswald , yvettte ) <eos> walk walk walk walk walk walk walk walk walk walk walk walk walk walk walk walk walk walk walk walk walk walk walk
oswald likes xerxes <eos>	like ( oswald , xerxes ) <eos>	like ( oswald , xerxes ) <eos> walk walk walk walk walk walk walk walk walk walk walk walk walk walk walk walk walk walk walk walk walk walk walk
oswald notices xerxes <eos>	notice ( oswald , xerxes ) <eos>	notice ( oswald , xerxes ) <eos> walk walk walk walk walk walk walk walk walk walk walk walk walk walk walk walk walk walk walk walk walk walk walk
oswald notices isla <eos>	notice ( oswald , isla ) <eos>	notice ( oswald , isla ) <eos> walk walk walk walk walk walk walk walk walk walk walk walk walk walk walk walk walk walk walk walk walk walk walk
oswald notices grace <eos>	notice ( oswald , grace ) <eos>	notice ( oswald , grace ) <eos> walk walk walk walk walk walk walk walk walk walk walk walk walk walk walk walk walk walk walk walk walk walk walk
oswald throws quinn <eos>	throw ( oswald , quinn ) <eos>	throw ( oswald , quinn ) <eos> walk walk walk walk walk walk walk walk walk walk walk walk walk walk walk walk walk walk walk walk walk walk walk
oswald throws lewis <eos>	throw ( oswald , lewis ) <eos>	throw ( oswald , lewis ) <eos> walk walk walk walk walk walk walk walk walk walk walk walk walk walk walk walk walk walk walk walk walk walk walk
patricia likes grace <eos>	like ( patricia , grace ) <eos>	like ( patricia , grace ) <eos> walk walk walk walk walk walk walk walk walk walk walk walk walk walk walk walk walk walk walk walk walk walk walk
patricia meets lewis <eos>	meet ( patricia , lewis ) <eos>	meet ( patricia , lewis ) <eos> walk walk walk walk walk walk walk walk walk walk walk walk walk walk walk walk walk walk walk walk walk walk walk
patricia sees claire <eos>	see ( patricia , claire ) <eos>	see ( patricia , claire ) <eos> walk walk walk walk walk walk walk walk walk walk walk walk walk walk walk walk walk walk walk walk walk walk walk
oswald knows patricia <eos>	know ( oswald , patricia ) <eos>	know ( oswald , patricia ) <eos> walk walk walk walk walk walk walk walk walk walk walk walk walk walk walk walk walk walk walk walk walk walk walk
oswald knows katherine <eos>	know ( oswald , katherine ) <eos>	know ( oswald , katherine ) <eos> walk walk walk walk walk walk walk walk walk walk walk walk walk walk walk walk walk walk walk walk walk walk walk
patricia dislikes isla <eos>	dislike ( patricia , isla ) <eos>	dislike ( patricia , isla ) <eos> walk walk walk walk walk walk walk walk walk walk walk walk walk walk walk walk walk walk walk walk walk walk walk
patricia dislikes henry <eos>	dislike ( patricia , henry ) <eos>	dislike ( patricia , henry ) <eos> walk walk walk walk walk walk walk walk walk walk walk walk walk walk walk walk walk walk walk walk walk walk walk
patricia dislikes eliza <eos>	dislike ( patricia , eliza ) <eos>	dislike ( patricia , eliza ) <eos> walk walk walk walk walk walk walk walk walk walk walk walk walk walk walk walk walk walk walk walk walk walk walk
patricia likes ursula <eos>	like ( patricia , ursula ) <eos>	like ( patricia , ursula ) <eos> walk walk walk walk walk walk walk walk walk walk walk walk walk walk walk walk walk walk walk walk walk walk walk
patricia likes quinn <eos>	like ( patricia , quinn ) <eos>	like ( patricia , quinn ) <eos> walk walk walk walk walk walk walk walk walk walk walk walk walk walk walk walk walk walk walk walk walk walk walk
patricia throws rachael <eos>	throw ( patricia , rachael ) <eos>	throw ( patricia , rachael ) <eos> walk walk walk walk walk walk walk walk walk walk walk walk walk walk walk walk walk walk walk walk walk walk walk
patricia throws eliza <eos>	throw ( patricia , eliza ) <eos>	throw ( patricia , eliza ) <eos> walk walk walk walk walk walk walk walk walk walk walk walk walk walk walk walk walk walk walk walk walk walk walk
patricia throws bob <eos>	throw ( patricia , bob ) <eos>	throw ( patricia , bob ) <eos> walk walk walk walk walk walk walk walk walk walk walk walk walk walk walk walk walk walk walk walk walk walk walk
patricia dislikes zelda <eos>	dislike ( patricia , zelda ) <eos>	dislike ( patricia , zelda ) <eos> walk walk walk walk walk walk walk walk walk walk walk walk walk walk walk walk walk walk walk walk walk walk walk
patricia dislikes tracy <eos>	dislike ( patricia , tracy ) <eos>	dislike ( patricia , tracy ) <eos> walk walk walk walk walk walk walk walk walk walk walk walk walk walk walk walk walk walk walk walk walk walk walk
patricia notices victor <eos>	notice ( patricia , victor ) <eos>	notice ( patricia , victor ) <eos> walk walk walk walk walk walk walk walk walk walk walk walk walk walk walk walk walk walk walk walk walk walk walk
patricia notices rachael <eos>	notice ( patricia , rachael ) <eos>	notice ( patricia , rachael ) <eos> walk walk walk walk walk walk walk walk walk walk walk walk walk walk walk walk walk walk walk walk walk walk walk
patricia notices grace <eos>	notice ( patricia , grace ) <eos>	notice ( patricia , grace ) <eos> walk walk walk walk walk walk walk walk walk walk walk walk walk walk walk walk walk walk walk walk walk walk walk
patricia notices francis <eos>	notice ( patricia , francis ) <eos>	notice ( patricia , francis ) <eos> walk walk walk walk walk walk walk walk walk walk walk walk walk walk walk walk walk walk walk walk walk walk walk
patricia throws winnifred <eos>	throw ( patricia , winnifred ) <eos>	throw ( patricia , winnifred ) <eos> walk walk walk walk walk walk walk walk walk walk walk walk walk walk walk walk walk walk walk walk walk walk walk
quinn likes alice <eos>	like ( quinn , alice ) <eos>	like ( quinn , alice ) <eos> walk walk walk walk walk walk walk walk walk walk walk walk walk walk walk walk walk walk walk walk walk walk walk
quinn meets bob <eos>	meet ( quinn , bob ) <eos>	meet ( quinn , bob ) <eos> walk walk walk walk walk walk walk walk walk walk walk walk walk walk walk walk walk walk walk walk walk walk walk
quinn sees tracy <eos>	see ( quinn , tracy ) <eos>	see ( quinn , tracy ) <eos> walk walk walk walk walk walk walk walk walk walk walk walk walk walk walk walk walk walk walk walk walk walk walk
patricia knows victor <eos>	know ( patricia , victor ) <eos>	know ( patricia , victor ) <eos> walk walk walk walk walk walk walk walk walk walk walk walk walk walk walk walk walk walk walk walk walk walk walk
patricia knows neha <eos>	know ( patricia , neha ) <eos>	know ( patricia , neha ) <eos> walk walk walk walk walk walk walk walk walk walk walk walk walk walk walk walk walk walk walk walk walk walk walk
quinn dislikes ursula <eos>	dislike ( quinn , ursula ) <eos>	dislike ( quinn , ursula ) <eos> walk walk walk walk walk walk walk walk walk walk walk walk walk walk walk walk walk walk walk walk walk walk walk
quinn dislikes margaret <eos>	dislike ( quinn , margaret ) <eos>	dislike ( quinn , margaret ) <eos> walk walk walk walk walk walk walk walk walk walk walk walk walk walk walk walk walk walk walk walk walk walk walk
quinn dislikes katherine <eos>	dislike ( quinn , katherine ) <eos>	dislike ( quinn , katherine ) <eos> walk walk walk walk walk walk walk walk walk walk walk walk walk walk walk walk walk walk walk walk walk walk walk
quinn likes ursula <eos>	like ( quinn , ursula ) <eos>	like ( quinn , ursula ) <eos> walk walk walk walk walk walk walk walk walk walk walk walk walk walk walk walk walk walk walk walk walk walk walk
quinn likes margaret <eos>	like ( quinn , margaret ) <eos>	like ( quinn , margaret ) <eos> walk walk walk walk walk walk walk walk walk walk walk walk walk walk walk walk walk walk walk walk walk walk walk
quinn knows alice <eos>	know ( quinn , alice ) <eos>	know ( quinn , alice ) <eos> walk walk walk walk walk walk walk walk walk walk walk walk walk walk walk walk walk walk walk walk walk walk walk
quinn notices ursula <eos>	notice ( quinn , ursula ) <eos>	notice ( quinn , ursula ) <eos> walk walk walk walk walk walk walk walk walk walk walk walk walk walk walk walk walk walk walk walk walk walk walk
quinn throws zelda <eos>	throw ( quinn , zelda ) <eos>	throw ( quinn , zelda ) <eos> walk walk walk walk walk walk walk walk walk walk walk walk walk walk walk walk walk walk walk walk walk walk walk
quinn throws quinn <eos>	throw ( quinn , quinn ) <eos>	throw ( quinn , quinn ) <eos> walk walk walk walk walk walk walk walk walk walk walk walk walk walk walk walk walk walk walk walk walk walk walk
quinn throws claire <eos>	throw ( quinn , claire ) <eos>	throw ( quinn , claire ) <eos> walk walk walk walk walk walk walk walk walk walk walk walk walk walk walk walk walk walk walk walk walk walk walk
rachael sees grace <eos>	see ( rachael , grace ) <eos>	see ( rachael , grace ) <eos> walk walk walk walk walk walk walk walk walk walk walk walk walk walk walk walk walk walk walk walk walk walk walk
quinn sees himself <eos>	see ( quinn , quinn ) <eos>	see ( quinn , quinn ) <eos> walk walk walk walk walk walk walk walk walk walk walk walk walk walk walk walk walk walk walk walk walk walk walk
quinn knows ursula <eos>	know ( quinn , ursula ) <eos>	know ( quinn , ursula ) <eos> walk walk walk walk walk walk walk walk walk walk walk walk walk walk walk walk walk walk walk walk walk walk walk
quinn knows tracy <eos>	know ( quinn , tracy ) <eos>	know ( quinn , tracy ) <eos> walk walk walk walk walk walk walk walk walk walk walk walk walk walk walk walk walk walk walk walk walk walk walk
quinn knows quinn <eos>	know ( quinn , quinn ) <eos>	know ( quinn , quinn ) <eos> walk walk walk walk walk walk walk walk walk walk walk walk walk walk walk walk walk walk walk walk walk walk walk
rachael likes samuel <eos>	like ( rachael , samuel ) <eos>	like ( rachael , samuel ) <eos> walk walk walk walk walk walk walk walk walk walk walk walk walk walk walk walk walk walk walk walk walk walk walk
rachael likes neha <eos>	like ( rachael , neha ) <eos>	like ( rachael , neha ) <eos> walk walk walk walk walk walk walk walk walk walk walk walk walk walk walk walk walk walk walk walk walk walk walk
rachael meets grace <eos>	meet ( rachael , grace ) <eos>	meet ( rachael , grace ) <eos> walk walk walk walk walk walk walk walk walk walk walk walk walk walk walk walk walk walk walk walk walk walk walk
rachael meets daniel <eos>	meet ( rachael , daniel ) <eos>	meet ( rachael , daniel ) <eos> walk walk walk walk walk walk walk walk walk walk walk walk walk walk walk walk walk walk walk walk walk walk walk
rachael sees yvette <eos>	see ( rachael , yvettte ) <eos>	see ( rachael , yvettte ) <eos> walk walk walk walk walk walk walk walk walk walk walk walk walk walk walk walk walk walk walk walk walk walk walk
rachael throws quinn <eos>	throw ( rachael , quinn ) <eos>	throw ( rachael , quinn ) <eos> walk walk walk walk walk walk walk walk walk walk walk walk walk walk walk walk walk walk walk walk walk walk walk
rachael dislikes winnifred <eos>	dislike ( rachael , winnifred ) <eos>	dislike ( rachael , winnifred ) <eos> walk walk walk walk walk walk walk walk walk walk walk walk walk walk walk walk walk walk walk walk walk walk walk
rachael dislikes samuel <eos>	dislike ( rachael , samuel ) <eos>	dislike ( rachael , samuel ) <eos> walk walk walk walk walk walk walk walk walk walk walk walk walk walk walk walk walk walk walk walk walk walk walk
rachael dislikes neha <eos>	dislike ( rachael , neha ) <eos>	dislike ( rachael , neha ) <eos> walk walk walk walk walk walk walk walk walk walk walk walk walk walk walk walk walk walk walk walk walk walk walk
rachael dislikes eliza <eos>	dislike ( rachael , eliza ) <eos>	dislike ( rachael , eliza ) <eos> walk walk walk walk walk walk walk walk walk walk walk walk walk walk walk walk walk walk walk walk walk walk walk
rachael notices katherine <eos>	notice ( rachael , katherine ) <eos>	notice ( rachael , katherine ) <eos> walk walk walk walk walk walk walk walk walk walk walk walk walk walk walk walk walk walk walk walk walk walk walk
rachael notices isla <eos>	notice ( rachael , isla ) <eos>	notice ( rachael , isla ) <eos> walk walk walk walk walk walk walk walk walk walk walk walk walk walk walk walk walk walk walk walk walk walk walk
rachael notices henry <eos>	notice ( rachael , henry ) <eos>	notice ( rachael , henry ) <eos> walk walk walk walk walk walk walk walk walk walk walk walk walk walk walk walk walk walk walk walk walk walk walk
rachael notices bob <eos>	notice ( rachael , bob ) <eos>	notice ( rachael , bob ) <eos> walk walk walk walk walk walk walk walk walk walk walk walk walk walk walk walk walk walk walk walk walk walk walk
rachael throws xerxes <eos>	throw ( rachael , xerxes ) <eos>	throw ( rachael , xerxes ) <eos> walk walk walk walk walk walk walk walk walk walk walk walk walk walk walk walk walk walk walk walk walk walk walk
rachael knows neha <eos>	know ( rachael , neha ) <eos>	know ( rachael , neha ) <eos> walk walk walk walk walk walk walk walk walk walk walk walk walk walk walk walk walk walk walk walk walk walk walk
rachael knows katherine <eos>	know ( rachael , katherine ) <eos>	know ( rachael , katherine ) <eos> walk walk walk walk walk walk walk walk walk walk walk walk walk walk walk walk walk walk walk walk walk walk walk
rachael knows john <eos>	know ( rachael , john ) <eos>	know ( rachael , john ) <eos> walk walk walk walk walk walk walk walk walk walk walk walk walk walk walk walk walk walk walk walk walk walk walk
rachael knows henry <eos>	know ( rachael , henry ) <eos>	know ( rachael , henry ) <eos> walk walk walk walk walk walk walk walk walk walk walk walk walk walk walk walk walk walk walk walk walk walk walk
rachael notices victor <eos>	notice ( rachael , victor ) <eos>	notice ( rachael , victor ) <eos> walk walk walk walk walk walk walk walk walk walk walk walk walk walk walk walk walk walk walk walk walk walk walk
samuel sees rachael <eos>	see ( samuel , rachael ) <eos>	see ( samuel , rachael ) <eos> walk walk walk walk walk walk walk walk walk walk walk walk walk walk walk walk walk walk walk walk walk walk walk
samuel sees patricia <eos>	see ( samuel , patricia ) <eos>	see ( samuel , patricia ) <eos> walk walk walk walk walk walk walk walk walk walk walk walk walk walk walk walk walk walk walk walk walk walk walk
samuel sees margaret <eos>	see ( samuel , margaret ) <eos>	see ( samuel , margaret ) <eos> walk walk walk walk walk walk walk walk walk walk walk walk walk walk walk walk walk walk walk walk walk walk walk
rachael knows samuel <eos>	know ( rachael , samuel ) <eos>	know ( rachael , samuel ) <eos> walk walk walk walk walk walk walk walk walk walk walk walk walk walk walk walk walk walk walk walk walk walk walk
rachael knows quinn <eos>	know ( rachael , quinn ) <eos>	know ( rachael , quinn ) <eos> walk walk walk walk walk walk walk walk walk walk walk walk walk walk walk walk walk walk walk walk walk walk walk
samuel dislikes katherine <eos>	dislike ( samuel , katherine ) <eos>	dislike ( samuel , katherine ) <eos> walk walk walk walk walk walk walk walk walk walk walk walk walk walk walk walk walk walk walk walk walk walk walk
samuel likes patricia <eos>	like ( samuel , patricia ) <eos>	like ( samuel , patricia ) <eos> walk walk walk walk walk walk walk walk walk walk walk walk walk walk walk walk walk walk walk walk walk walk walk
samuel meets xerxes <eos>	meet ( samuel , xerxes ) <eos>	meet ( samuel , xerxes ) <eos> walk walk walk walk walk walk walk walk walk walk walk walk walk walk walk walk walk walk walk walk walk walk walk
samuel sees ursula <eos>	see ( samuel , ursula ) <eos>	see ( samuel , ursula ) <eos> walk walk walk walk walk walk walk walk walk walk walk walk walk walk walk walk walk walk walk walk walk walk walk
samuel sees samuel <eos>	see ( samuel , samuel ) <eos>	see ( samuel , samuel ) <eos> walk walk walk walk walk walk walk walk walk walk walk walk walk walk walk walk walk walk walk walk walk walk walk
samuel notices rachael <eos>	notice ( samuel , rachael ) <eos>	notice ( samuel , rachael ) <eos> walk walk walk walk walk walk walk walk walk walk walk walk walk walk walk walk walk walk walk walk walk walk walk
samuel throws yvette <eos>	throw ( samuel , yvettte ) <eos>	throw ( samuel , yvettte ) <eos> walk walk walk walk walk walk walk walk walk walk walk walk walk walk walk walk walk walk walk walk walk walk walk
samuel throws victor <eos>	throw ( samuel , victor ) <eos>	throw ( samuel , victor ) <eos> walk walk walk walk walk walk walk walk walk walk walk walk walk walk walk walk walk walk walk walk walk walk walk
samuel dislikes zelda <eos>	dislike ( samuel , zelda ) <eos>	dislike ( samuel , zelda ) <eos> walk walk walk walk walk walk walk walk walk walk walk walk walk walk walk walk walk walk walk walk walk walk walk
samuel dislikes patricia <eos>	dislike ( samuel , patricia ) <eos>	dislike ( samuel , patricia ) <eos> walk walk walk walk walk walk walk walk walk walk walk walk walk walk walk walk walk walk walk walk walk walk walk
samuel meets himself <eos>	meet ( samuel , samuel ) <eos>	meet ( samuel , samuel ) <eos> walk walk walk walk walk walk walk walk walk walk walk walk walk walk walk walk walk walk walk walk walk walk walk
samuel knows victor <eos>	know ( samuel , victor ) <eos>	know ( samuel , victor ) <eos> walk walk walk walk walk walk walk walk walk walk walk walk walk walk walk walk walk walk walk walk walk walk walk
samuel knows patricia <eos>	know ( samuel , patricia ) <eos>	know ( samuel , patricia ) <eos> walk walk walk walk walk walk walk walk walk walk walk walk walk walk walk walk walk walk walk walk walk walk walk
samuel knows grace <eos>	know ( samuel , grace ) <eos>	know ( samuel , grace ) <eos> walk walk walk walk walk walk walk walk walk walk walk walk walk walk walk walk walk walk walk walk walk walk walk
samuel notices yvette <eos>	notice ( samuel , yvettte ) <eos>	notice ( samuel , yvettte ) <eos> walk walk walk walk walk walk walk walk walk walk walk walk walk walk walk walk walk walk walk walk walk walk walk
tracy sees quinn <eos>	see ( tracy , quinn ) <eos>	see ( tracy , quinn ) <eos> walk walk walk walk walk walk walk walk walk walk walk walk walk walk walk walk walk walk walk walk walk walk walk
tracy sees oswald <eos>	see ( tracy , oswald ) <eos>	see ( tracy , oswald ) <eos> walk walk walk walk walk walk walk walk walk walk walk walk walk walk walk walk walk walk walk walk walk walk walk
tracy sees john <eos>	see ( tracy , john ) <eos>	see ( tracy , john ) <eos> walk walk walk walk walk walk walk walk walk walk walk walk walk walk walk walk walk walk walk walk walk walk walk
tracy sees alice <eos>	see ( tracy , alice ) <eos>	see ( tracy , alice ) <eos> walk walk walk walk walk walk walk walk walk walk walk walk walk walk walk walk walk walk walk walk walk walk walk
samuel notices himself <eos>	notice ( samuel , samuel ) <eos>	notice ( samuel , samuel ) <eos> walk walk walk walk walk walk walk walk walk walk walk walk walk walk walk walk walk walk walk walk walk walk walk
tracy likes grace <eos>	like ( tracy , grace ) <eos>	like ( tracy , grace ) <eos> walk walk walk walk walk walk walk walk walk walk walk walk walk walk walk walk walk walk walk walk walk walk walk
tracy likes claire <eos>	like ( tracy , claire ) <eos>	like ( tracy , claire ) <eos> walk walk walk walk walk walk walk walk walk walk walk walk walk walk walk walk walk walk walk walk walk walk walk
tracy meets zelda <eos>	meet ( tracy , zelda ) <eos>	meet ( tracy , zelda ) <eos> walk walk walk walk walk walk walk walk walk walk walk walk walk walk walk walk walk walk walk walk walk walk walk
tracy meets eliza <eos>	meet ( tracy , eliza ) <eos>	meet ( tracy , eliza ) <eos> walk walk walk walk walk walk walk walk walk walk walk walk walk walk walk walk walk walk walk walk walk walk walk
tracy meets daniel <eos>	meet ( tracy , daniel ) <eos>	meet ( tracy , daniel ) <eos> walk walk walk walk walk walk walk walk walk walk walk walk walk walk walk walk walk walk walk walk walk walk walk
tracy notices rachael <eos>	notice ( tracy , rachael ) <eos>	notice ( tracy , rachael ) <eos> walk walk walk walk walk walk walk walk walk walk walk walk walk walk walk walk walk walk walk walk walk walk walk
tracy throws victor <eos>	throw ( tracy , victor ) <eos>	throw ( tracy , victor ) <eos> walk walk walk walk walk walk walk walk walk walk walk walk walk walk walk walk walk walk walk walk walk walk walk
tracy throws isla <eos>	throw ( tracy , isla ) <eos>	throw ( tracy , isla ) <eos> walk walk walk walk walk walk walk walk walk walk walk walk walk walk walk walk walk walk walk walk walk walk walk
tracy dislikes xerxes <eos>	dislike ( tracy , xerxes ) <eos>	dislike ( tracy , xerxes ) <eos> walk walk walk walk walk walk walk walk walk walk walk walk walk walk walk walk walk walk walk walk walk walk walk
tracy dislikes neha <eos>	dislike ( tracy , neha ) <eos>	dislike ( tracy , neha ) <eos> walk walk walk walk walk walk walk walk walk walk walk walk walk walk walk walk walk walk walk walk walk walk walk
ursula likes rachael <eos>	like ( ursula , rachael ) <eos>	like ( ursula , rachael ) <eos> walk walk walk walk walk walk walk walk walk walk walk walk walk walk walk walk walk walk walk walk walk walk walk
ursula meets winnifred <eos>	meet ( ursula , winnifred ) <eos>	meet ( ursula , winnifred ) <eos> walk walk walk walk walk walk walk walk walk walk walk walk walk walk walk walk walk walk walk walk walk walk walk
ursula meets john <eos>	meet ( ursula , john ) <eos>	meet ( ursula , john ) <eos> walk walk walk walk walk walk walk walk walk walk walk walk walk walk walk walk walk walk walk walk walk walk walk
tracy knows victor <eos>	know ( tracy , victor ) <eos>	know ( tracy , victor ) <eos> walk walk walk walk walk walk walk walk walk walk walk walk walk walk walk walk walk walk walk walk walk walk walk
tracy notices victor <eos>	notice ( tracy , victor ) <eos>	notice ( tracy , victor ) <eos> walk walk walk walk walk walk walk walk walk walk walk walk walk walk walk walk walk walk walk walk walk walk walk
ursula notices katherine <eos>	notice ( ursula , katherine ) <eos>	notice ( ursula , katherine ) <eos> walk walk walk walk walk walk walk walk walk walk walk walk walk walk walk walk walk walk walk walk walk walk walk
ursula throws winnifred <eos>	throw ( ursula , winnifred ) <eos>	throw ( ursula , winnifred ) <eos> walk walk walk walk walk walk walk walk walk walk walk walk walk walk walk walk walk walk walk walk walk walk walk
ursula throws tracy <eos>	throw ( ursula , tracy ) <eos>	throw ( ursula , tracy ) <eos> walk walk walk walk walk walk walk walk walk walk walk walk walk walk walk walk walk walk walk walk walk walk walk
ursula throws isla <eos>	throw ( ursula , isla ) <eos>	throw ( ursula , isla ) <eos> walk walk walk walk walk walk walk walk walk walk walk walk walk walk walk walk walk walk walk walk walk walk walk
ursula dislikes quinn <eos>	dislike ( ursula , quinn ) <eos>	dislike ( ursula , quinn ) <eos> walk walk walk walk walk walk walk walk walk walk walk walk walk walk walk walk walk walk walk walk walk walk walk
victor sees lewis <eos>	see ( victor , lewis ) <eos>	see ( victor , lewis ) <eos> walk walk walk walk walk walk walk walk walk walk walk walk walk walk walk walk walk walk walk walk walk walk walk
ursula sees herself <eos>	see ( ursula , ursula ) <eos>	see ( ursula , ursula ) <eos> walk walk walk walk walk walk walk walk walk walk walk walk walk walk walk walk walk walk walk walk walk walk walk
ursula knows tracy <eos>	know ( ursula , tracy ) <eos>	know ( ursula , tracy ) <eos> walk walk walk walk walk walk walk walk walk walk walk walk walk walk walk walk walk walk walk walk walk walk walk
ursula notices samuel <eos>	notice ( ursula , samuel ) <eos>	notice ( ursula , samuel ) <eos> walk walk walk walk walk walk walk walk walk walk walk walk walk walk walk walk walk walk walk walk walk walk walk
ursula notices rachael <eos>	notice ( ursula , rachael ) <eos>	notice ( ursula , rachael ) <eos> walk walk walk walk walk walk walk walk walk walk walk walk walk walk walk walk walk walk walk walk walk walk walk
victor meets samuel <eos>	meet ( victor , samuel ) <eos>	meet ( victor , samuel ) <eos> walk walk walk walk walk walk walk walk walk walk walk walk walk walk walk walk walk walk walk walk walk walk walk
victor meets grace <eos>	meet ( victor , grace ) <eos>	meet ( victor , grace ) <eos> walk walk walk walk walk walk walk walk walk walk walk walk walk walk walk walk walk walk walk walk walk walk walk
victor meets eliza <eos>	meet ( victor , eliza ) <eos>	meet ( victor , eliza ) <eos> walk walk walk walk walk walk walk walk walk walk walk walk walk walk walk walk walk walk walk walk walk walk walk
victor meets claire <eos>	meet ( victor , claire ) <eos>	meet ( victor , claire ) <eos> walk walk walk walk walk walk walk walk walk walk walk walk walk walk walk walk walk walk walk walk walk walk walk
victor sees samuel <eos>	see ( victor , samuel ) <eos>	see ( victor , samuel ) <eos> walk walk walk walk walk walk walk walk walk walk walk walk walk walk walk walk walk walk walk walk walk walk walk
victor dislikes daniel <eos>	dislike ( victor , daniel ) <eos>	dislike ( victor , daniel ) <eos> walk walk walk walk walk walk walk walk walk walk walk walk walk walk walk walk walk walk walk walk walk walk walk
victor dislikes claire <eos>	dislike ( victor , claire ) <eos>	dislike ( victor , claire ) <eos> walk walk walk walk walk walk walk walk walk walk walk walk walk walk walk walk walk walk walk walk walk walk walk
victor likes tracy <eos>	like ( victor , tracy ) <eos>	like ( victor , tracy ) <eos> walk walk walk walk walk walk walk walk walk walk walk walk walk walk walk walk walk walk walk walk walk walk walk
victor likes samuel <eos>	like ( victor , samuel ) <eos>	like ( victor , samuel ) <eos> walk walk walk walk walk walk walk walk walk walk walk walk walk walk walk walk walk walk walk walk walk walk walk
victor likes margaret <eos>	like ( victor , margaret ) <eos>	like ( victor , margaret ) <eos> walk walk walk walk walk walk walk walk walk walk walk walk walk walk walk walk walk walk walk walk walk walk walk
victor knows henry <eos>	know ( victor , henry ) <eos>	know ( victor , henry ) <eos> walk walk walk walk walk walk walk walk walk walk walk walk walk walk walk walk walk walk walk walk walk walk walk
victor notices rachael <eos>	notice ( victor , rachael ) <eos>	notice ( victor , rachael ) <eos> walk walk walk walk walk walk walk walk walk walk walk walk walk walk walk walk walk walk walk walk walk walk walk
victor notices bob <eos>	notice ( victor , bob ) <eos>	notice ( victor , bob ) <eos> walk walk walk walk walk walk walk walk walk walk walk walk walk walk walk walk walk walk walk walk walk walk walk
victor throws margaret <eos>	throw ( victor , margaret ) <eos>	throw ( victor , margaret ) <eos> walk walk walk walk walk walk walk walk walk walk walk walk walk walk walk walk walk walk walk walk walk walk walk
victor throws grace <eos>	throw ( victor , grace ) <eos>	throw ( victor , grace ) <eos> walk walk walk walk walk walk walk walk walk walk walk walk walk walk walk walk walk walk walk walk walk walk walk
winnifred sees rachael <eos>	see ( winnifred , rachael ) <eos>	see ( winnifred , rachael ) <eos> walk walk walk walk walk walk walk walk walk walk walk walk walk walk walk walk walk walk walk walk walk walk walk
winnifred sees isla <eos>	see ( winnifred , isla ) <eos>	see ( winnifred , isla ) <eos> walk walk walk walk walk walk walk walk walk walk walk walk walk walk walk walk walk walk walk walk walk walk walk
winnifred sees francis <eos>	see ( winnifred , francis ) <eos>	see ( winnifred , francis ) <eos> walk walk walk walk walk walk walk walk walk walk walk walk walk walk walk walk walk walk walk walk walk walk walk
victor knows patricia <eos>	know ( victor , patricia ) <eos>	know ( victor , patricia ) <eos> walk walk walk walk walk walk walk walk walk walk walk walk walk walk walk walk walk walk walk walk walk walk walk
victor knows oswald <eos>	know ( victor , oswald ) <eos>	know ( victor , oswald ) <eos> walk walk walk walk walk walk walk walk walk walk walk walk walk walk walk walk walk walk walk walk walk walk walk
winnifred meets tracy <eos>	meet ( winnifred , tracy ) <eos>	meet ( winnifred , tracy ) <eos> walk walk walk walk walk walk walk walk walk walk walk walk walk walk walk walk walk walk walk walk walk walk walk
winnifred meets john <eos>	meet ( winnifred , john ) <eos>	meet ( winnifred , john ) <eos> walk walk walk walk walk walk walk walk walk walk walk walk walk walk walk walk walk walk walk walk walk walk walk
winnifred meets grace <eos>	meet ( winnifred , grace ) <eos>	meet ( winnifred , grace ) <eos> walk walk walk walk walk walk walk walk walk walk walk walk walk walk walk walk walk walk walk walk walk walk walk
winnifred sees xerxes <eos>	see ( winnifred , xerxes ) <eos>	see ( winnifred , xerxes ) <eos> walk walk walk walk walk walk walk walk walk walk walk walk walk walk walk walk walk walk walk walk walk walk walk
winnifred sees victor <eos>	see ( winnifred , victor ) <eos>	see ( winnifred , victor ) <eos> walk walk walk walk walk walk walk walk walk walk walk walk walk walk walk walk walk walk walk walk walk walk walk
winnifred dislikes alice <eos>	dislike ( winnifred , alice ) <eos>	dislike ( winnifred , alice ) <eos> walk walk walk walk walk walk walk walk walk walk walk walk walk walk walk walk walk walk walk walk walk walk walk
winnifred likes winnifred <eos>	like ( winnifred , winnifred ) <eos>	like ( winnifred , winnifred ) <eos> walk walk walk walk walk walk walk walk walk walk walk walk walk walk walk walk walk walk walk walk walk walk walk
winnifred likes tracy <eos>	like ( winnifred , tracy ) <eos>	like ( winnifred , tracy ) <eos> walk walk walk walk walk walk walk walk walk walk walk walk walk walk walk walk walk walk walk walk walk walk walk
winnifred likes neha <eos>	like ( winnifred , neha ) <eos>	like ( winnifred , neha ) <eos> walk walk walk walk walk walk walk walk walk walk walk walk walk walk walk walk walk walk walk walk walk walk walk
winnifred likes lewis <eos>	like ( winnifred , lewis ) <eos>	like ( winnifred , lewis ) <eos> walk walk walk walk walk walk walk walk walk walk walk walk walk walk walk walk walk walk walk walk walk walk walk
winnifred throws lewis <eos>	throw ( winnifred , lewis ) <eos>	throw ( winnifred , lewis ) <eos> walk walk walk walk walk walk walk walk walk walk walk walk walk walk walk walk walk walk walk walk walk walk walk
winnifred throws katherine <eos>	throw ( winnifred , katherine ) <eos>	throw ( winnifred , katherine ) <eos> walk walk walk walk walk walk walk walk walk walk walk walk walk walk walk walk walk walk walk walk walk walk walk
winnifred dislikes samuel <eos>	dislike ( winnifred , samuel ) <eos>	dislike ( winnifred , samuel ) <eos> walk walk walk walk walk walk walk walk walk walk walk walk walk walk walk walk walk walk walk walk walk walk walk
winnifred dislikes john <eos>	dislike ( winnifred , john ) <eos>	dislike ( winnifred , john ) <eos> walk walk walk walk walk walk walk walk walk walk walk walk walk walk walk walk walk walk walk walk walk walk walk
winnifred dislikes francis <eos>	dislike ( winnifred , francis ) <eos>	dislike ( winnifred , francis ) <eos> walk walk walk walk walk walk walk walk walk walk walk walk walk walk walk walk walk walk walk walk walk walk walk
winnifred throws winnifred <eos>	throw ( winnifred , winnifred ) <eos>	throw ( winnifred , winnifred ) <eos> walk walk walk walk walk walk walk walk walk walk walk walk walk walk walk walk walk walk walk walk walk walk walk
winnifred throws victor <eos>	throw ( winnifred , victor ) <eos>	throw ( winnifred , victor ) <eos> walk walk walk walk walk walk walk walk walk walk walk walk walk walk walk walk walk walk walk walk walk walk walk
winnifred throws patricia <eos>	throw ( winnifred , patricia ) <eos>	throw ( winnifred , patricia ) <eos> walk walk walk walk walk walk walk walk walk walk walk walk walk walk walk walk walk walk walk walk walk walk walk
winnifred throws neha <eos>	throw ( winnifred , neha ) <eos>	throw ( winnifred , neha ) <eos> walk walk walk walk walk walk walk walk walk walk walk walk walk walk walk walk walk walk walk walk walk walk walk
winnifred throws margaret <eos>	throw ( winnifred , margaret ) <eos>	throw ( winnifred , margaret ) <eos> walk walk walk walk walk walk walk walk walk walk walk walk walk walk walk walk walk walk walk walk walk walk walk
winnifred knows quinn <eos>	know ( winnifred , quinn ) <eos>	know ( winnifred , quinn ) <eos> walk walk walk walk walk walk walk walk walk walk walk walk walk walk walk walk walk walk walk walk walk walk walk
winnifred knows grace <eos>	know ( winnifred , grace ) <eos>	know ( winnifred , grace ) <eos> walk walk walk walk walk walk walk walk walk walk walk walk walk walk walk walk walk walk walk walk walk walk walk
winnifred knows daniel <eos>	know ( winnifred , daniel ) <eos>	know ( winnifred , daniel ) <eos> walk walk walk walk walk walk walk walk walk walk walk walk walk walk walk walk walk walk walk walk walk walk walk
winnifred notices ursula <eos>	notice ( winnifred , ursula ) <eos>	notice ( winnifred , ursula ) <eos> walk walk walk walk walk walk walk walk walk walk walk walk walk walk walk walk walk walk walk walk walk walk walk
winnifred notices john <eos>	notice ( winnifred , john ) <eos>	notice ( winnifred , john ) <eos> walk walk walk walk walk walk walk walk walk walk walk walk walk walk walk walk walk walk walk walk walk walk walk
xerxes meets ursula <eos>	meet ( xerxes , ursula ) <eos>	meet ( xerxes , ursula ) <eos> walk walk walk walk walk walk walk walk walk walk walk walk walk walk walk walk walk walk walk walk walk walk walk
xerxes meets francis <eos>	meet ( xerxes , francis ) <eos>	meet ( xerxes , francis ) <eos> walk walk walk walk walk walk walk walk walk walk walk walk walk walk walk walk walk walk walk walk walk walk walk
xerxes sees rachael <eos>	see ( xerxes , rachael ) <eos>	see ( xerxes , rachael ) <eos> walk walk walk walk walk walk walk walk walk walk walk walk walk walk walk walk walk walk walk walk walk walk walk
xerxes sees grace <eos>	see ( xerxes , grace ) <eos>	see ( xerxes , grace ) <eos> walk walk walk walk walk walk walk walk walk walk walk walk walk walk walk walk walk walk walk walk walk walk walk
winnifred knows ursula <eos>	know ( winnifred , ursula ) <eos>	know ( winnifred , ursula ) <eos> walk walk walk walk walk walk walk walk walk walk walk walk walk walk walk walk walk walk walk walk walk walk walk
xerxes notices rachael <eos>	notice ( xerxes , rachael ) <eos>	notice ( xerxes , rachael ) <eos> walk walk walk walk walk walk walk walk walk walk walk walk walk walk walk walk walk walk walk walk walk walk walk
xerxes notices henry <eos>	notice ( xerxes , henry ) <eos>	notice ( xerxes , henry ) <eos> walk walk walk walk walk walk walk walk walk walk walk walk walk walk walk walk walk walk walk walk walk walk walk
xerxes likes neha <eos>	like ( xerxes , neha ) <eos>	like ( xerxes , neha ) <eos> walk walk walk walk walk walk walk walk walk walk walk walk walk walk walk walk walk walk walk walk walk walk walk
xerxes likes margaret <eos>	like ( xerxes , margaret ) <eos>	like ( xerxes , margaret ) <eos> walk walk walk walk walk walk walk walk walk walk walk walk walk walk walk walk walk walk walk walk walk walk walk
xerxes meets xerxes <eos>	meet ( xerxes , xerxes ) <eos>	meet ( xerxes , xerxes ) <eos> walk walk walk walk walk walk walk walk walk walk walk walk walk walk walk walk walk walk walk walk walk walk walk
xerxes sees himself <eos>	see ( xerxes , xerxes ) <eos>	see ( xerxes , xerxes ) <eos> walk walk walk walk walk walk walk walk walk walk walk walk walk walk walk walk walk walk walk walk walk walk walk
xerxes knows xerxes <eos>	know ( xerxes , xerxes ) <eos>	know ( xerxes , xerxes ) <eos> walk walk walk walk walk walk walk walk walk walk walk walk walk walk walk walk walk walk walk walk walk walk walk
xerxes knows tracy <eos>	know ( xerxes , tracy ) <eos>	know ( xerxes , tracy ) <eos> walk walk walk walk walk walk walk walk walk walk walk walk walk walk walk walk walk walk walk walk walk walk walk
xerxes knows neha <eos>	know ( xerxes , neha ) <eos>	know ( xerxes , neha ) <eos> walk walk walk walk walk walk walk walk walk walk walk walk walk walk walk walk walk walk walk walk walk walk walk
xerxes notices samuel <eos>	notice ( xerxes , samuel ) <eos>	notice ( xerxes , samuel ) <eos> walk walk walk walk walk walk walk walk walk walk walk walk walk walk walk walk walk walk walk walk walk walk walk
yvette sees tracy <eos>	see ( yvettte , tracy ) <eos>	see ( yvettte , tracy ) <eos> walk walk walk walk walk walk walk walk walk walk walk walk walk walk walk walk walk walk walk walk walk walk walk
yvette sees samuel <eos>	see ( yvettte , samuel ) <eos>	see ( yvettte , samuel ) <eos> walk walk walk walk walk walk walk walk walk walk walk walk walk walk walk walk walk walk walk walk walk walk walk
yvette sees alice <eos>	see ( yvettte , alice ) <eos>	see ( yvettte , alice ) <eos> walk walk walk walk walk walk walk walk walk walk walk walk walk walk walk walk walk walk walk walk walk walk walk
xerxes likes himself <eos>	like ( xerxes , xerxes ) <eos>	like ( xerxes , xerxes ) <eos> walk walk walk walk walk walk walk walk walk walk walk walk walk walk walk walk walk walk walk walk walk walk walk
xerxes meets himself <eos>	meet ( xerxes , xerxes ) <eos>	meet ( xerxes , xerxes ) <eos> walk walk walk walk walk walk walk walk walk walk walk walk walk walk walk walk walk walk walk walk walk walk walk
yvette dislikes isla <eos>	dislike ( yvettte , isla ) <eos>	dislike ( yvettte , isla ) <eos> walk walk walk walk walk walk walk walk walk walk walk walk walk walk walk walk walk walk walk walk walk walk walk
yvette likes lewis <eos>	like ( yvettte , lewis ) <eos>	like ( yvettte , lewis ) <eos> walk walk walk walk walk walk walk walk walk walk walk walk walk walk walk walk walk walk walk walk walk walk walk
yvette likes bob <eos>	like ( yvettte , bob ) <eos>	like ( yvettte , bob ) <eos> walk walk walk walk walk walk walk walk walk walk walk walk walk walk walk walk walk walk walk walk walk walk walk
yvette meets xerxes <eos>	meet ( yvettte , xerxes ) <eos>	meet ( yvettte , xerxes ) <eos> walk walk walk walk walk walk walk walk walk walk walk walk walk walk walk walk walk walk walk walk walk walk walk
yvette sees ursula <eos>	see ( yvettte , ursula ) <eos>	see ( yvettte , ursula ) <eos> walk walk walk walk walk walk walk walk walk walk walk walk walk walk walk walk walk walk walk walk walk walk walk
yvette notices rachael <eos>	notice ( yvettte , rachael ) <eos>	notice ( yvettte , rachael ) <eos> walk walk walk walk walk walk walk walk walk walk walk walk walk walk walk walk walk walk walk walk walk walk walk
yvette throws yvette <eos>	throw ( yvettte , yvettte ) <eos>	throw ( yvettte , yvettte ) <eos> walk walk walk walk walk walk walk walk walk walk walk walk walk walk walk walk walk walk walk walk walk walk walk
yvette throws katherine <eos>	throw ( yvettte , katherine ) <eos>	throw ( yvettte , katherine ) <eos> walk walk walk walk walk walk walk walk walk walk walk walk walk walk walk walk walk walk walk walk walk walk walk
yvette throws alice <eos>	throw ( yvettte , alice ) <eos>	throw ( yvettte , alice ) <eos> walk walk walk walk walk walk walk walk walk walk walk walk walk walk walk walk walk walk walk walk walk walk walk
yvette dislikes ursula <eos>	dislike ( yvettte , ursula ) <eos>	dislike ( yvettte , ursula ) <eos> walk walk walk walk walk walk walk walk walk walk walk walk walk walk walk walk walk walk walk walk walk walk walk
zelda meets oswald <eos>	meet ( zelda , oswald ) <eos>	meet ( zelda , oswald ) <eos> walk walk walk walk walk walk walk walk walk walk walk walk walk walk walk walk walk walk walk walk walk walk walk
zelda meets eliza <eos>	meet ( zelda , eliza ) <eos>	meet ( zelda , eliza ) <eos> walk walk walk walk walk walk walk walk walk walk walk walk walk walk walk walk walk walk walk walk walk walk walk
zelda sees victor <eos>	see ( zelda , victor ) <eos>	see ( zelda , victor ) <eos> walk walk walk walk walk walk walk walk walk walk walk walk walk walk walk walk walk walk walk walk walk walk walk
yvette notices herself <eos>	notice ( yvettte , yvettte ) <eos>	notice ( yvettte , yvettte ) <eos> walk walk walk walk walk walk walk walk walk walk walk walk walk walk walk walk walk walk walk walk walk walk walk
yvette knows eliza <eos>	know ( yvettte , eliza ) <eos>	know ( yvettte , eliza ) <eos> walk walk walk walk walk walk walk walk walk walk walk walk walk walk walk walk walk walk walk walk walk walk walk
zelda dislikes eliza <eos>	dislike ( zelda , eliza ) <eos>	dislike ( zelda , eliza ) <eos> walk walk walk walk walk walk walk walk walk walk walk walk walk walk walk walk walk walk walk walk walk walk walk
zelda dislikes daniel <eos>	dislike ( zelda , daniel ) <eos>	dislike ( zelda , daniel ) <eos> walk walk walk walk walk walk walk walk walk walk walk walk walk walk walk walk walk walk walk walk walk walk walk
zelda likes eliza <eos>	like ( zelda , eliza ) <eos>	like ( zelda , eliza ) <eos> walk walk walk walk walk walk walk walk walk walk walk walk walk walk walk walk walk walk walk walk walk walk walk
zelda likes claire <eos>	like ( zelda , claire ) <eos>	like ( zelda , claire ) <eos> walk walk walk walk walk walk walk walk walk walk walk walk walk walk walk walk walk walk walk walk walk walk walk
zelda likes alice <eos>	like ( zelda , alice ) <eos>	like ( zelda , alice ) <eos> walk walk walk walk walk walk walk walk walk walk walk walk walk walk walk walk walk walk walk walk walk walk walk
zelda throws lewis <eos>	throw ( zelda , lewis ) <eos>	throw ( zelda , lewis ) <eos> walk walk walk walk walk walk walk walk walk walk walk walk walk walk walk walk walk walk walk walk walk walk walk
zelda throws claire <eos>	throw ( zelda , claire ) <eos>	throw ( zelda , claire ) <eos> walk walk walk walk walk walk walk walk walk walk walk walk walk walk walk walk walk walk walk walk walk walk walk
zelda dislikes samuel <eos>	dislike ( zelda , samuel ) <eos>	dislike ( zelda , samuel ) <eos> walk walk walk walk walk walk walk walk walk walk walk walk walk walk walk walk walk walk walk walk walk walk walk
zelda dislikes rachael <eos>	dislike ( zelda , rachael ) <eos>	dislike ( zelda , rachael ) <eos> walk walk walk walk walk walk walk walk walk walk walk walk walk walk walk walk walk walk walk walk walk walk walk
zelda dislikes henry <eos>	dislike ( zelda , henry ) <eos>	dislike ( zelda , henry ) <eos> walk walk walk walk walk walk walk walk walk walk walk walk walk walk walk walk walk walk walk walk walk walk walk
zelda knows winnifred <eos>	know ( zelda , winnifred ) <eos>	know ( zelda , winnifred ) <eos> walk walk walk walk walk walk walk walk walk walk walk walk walk walk walk walk walk walk walk walk walk walk walk
zelda notices oswald <eos>	notice ( zelda , oswald ) <eos>	notice ( zelda , oswald ) <eos> walk walk walk walk walk walk walk walk walk walk walk walk walk walk walk walk walk walk walk walk walk walk walk
zelda notices lewis <eos>	notice ( zelda , lewis ) <eos>	notice ( zelda , lewis ) <eos> walk walk walk walk walk walk walk walk walk walk walk walk walk walk walk walk walk walk walk walk walk walk walk
zelda throws yvette <eos>	throw ( zelda , yvettte ) <eos>	throw ( zelda , yvettte ) <eos> walk walk walk walk walk walk walk walk walk walk walk walk walk walk walk walk walk walk walk walk walk walk walk
