source	target	prediction
alice likes samuel <eos>	like ( alice , samuel ) <eos>	alice ( samuel , samuel ) <eos>
alice dislikes yvette <eos>	dislike ( alice , yvettte ) <eos>	dislike ( claire , yvettte ) <eos>
alice likes lewis <eos>	like ( alice , lewis ) <eos>	like ( isla , lewis ) <eos>
alice dislikes victor <eos>	dislike ( alice , victor ) <eos>	dislike ( lewis , victor ) <eos>
alice dislikes eliza <eos>	dislike ( alice , eliza ) <eos>	dislike ( quinn , katherine ) <eos>
alice likes zelda <eos>	like ( alice , zelda ) <eos>	like ( zelda , zelda ) <eos>
alice notices zelda <eos>	notice ( alice , zelda ) <eos>	alice ( tracy , zelda ) <eos>
alice knows isla <eos>	know ( alice , isla ) <eos>	know ( isla , isla ) <eos>
alice throws daniel <eos>	throw ( alice , daniel ) <eos>	alice ( throw , daniel ) <eos>
alice notices winnifred <eos>	notice ( alice , winnifred ) <eos>	notice ( samuel , winnifred ) <eos>
alice meets samuel <eos>	meet ( alice , samuel ) <eos>	alice ( samuel , samuel ) <eos>
alice dislikes claire <eos>	dislike ( alice , claire ) <eos>	dislike ( john , claire ) <eos>
alice dislikes oswald <eos>	dislike ( alice , oswald ) <eos>	dislike ( katherine , oswald ) <eos>
alice dislikes quinn <eos>	dislike ( alice , quinn ) <eos>	dislike ( samuel , quinn ) <eos>
alice notices oswald <eos>	notice ( alice , oswald ) <eos>	alice ( neha , oswald ) <eos>
alice throws quinn <eos>	throw ( alice , quinn ) <eos>	alice ( throw , quinn ) <eos>
alice sees rachael <eos>	see ( alice , rachael ) <eos>	see ( katherine , rachael ) <eos>
alice knows oswald <eos>	know ( alice , oswald ) <eos>	know ( katherine , oswald ) <eos>
alice throws yvette <eos>	throw ( alice , yvettte ) <eos>	alice ( claire , yvettte ) <eos>
alice meets ursula <eos>	meet ( alice , ursula ) <eos>	alice ( tracy , ursula ) <eos>
alice walks <eos>	walk ( alice ) <eos>	alice ( yvettte ) <eos>
alice flies <eos>	fly ( alice ) <eos>	alice ( victor ) <eos>
alice runs <eos>	run ( alice ) <eos>	alice ( samuel , claire ) <eos>
alice eats <eos>	eat ( alice ) <eos>	alice ( samuel ) <eos>
alice dances <eos>	dance ( alice ) <eos>	alice ( throw ) <eos>
alice notices margaret <eos>	notice ( alice , margaret ) <eos>	alice ( katherine , margaret ) <eos>
alice throws oswald <eos>	throw ( alice , oswald ) <eos>	alice ( throw , oswald ) <eos>
alice knows rachael <eos>	know ( alice , rachael ) <eos>	know ( katherine , rachael ) <eos>
alice knows ursula <eos>	know ( alice , ursula ) <eos>	know ( tracy , ursula ) <eos>
alice notices victor <eos>	notice ( alice , victor ) <eos>	alice ( john , victor ) <eos>
alice dislikes daniel <eos>	dislike ( alice , daniel ) <eos>	dislike ( neha , daniel ) <eos>
alice notices eliza <eos>	notice ( alice , eliza ) <eos>	alice ( throw , john ) <eos>
alice knows zelda <eos>	know ( alice , zelda ) <eos>	know ( zelda , zelda ) <eos>
alice throws alice <eos>	throw ( alice , alice ) <eos>	alice ( throw , throw ) <eos>
alice notices henry <eos>	notice ( alice , henry ) <eos>	alice ( john , henry ) <eos>
alice notices john <eos>	notice ( alice , john ) <eos>	alice ( katherine , john ) <eos>
alice knows henry <eos>	know ( alice , henry ) <eos>	alice ( katherine , henry ) <eos>
alice sees patricia <eos>	see ( alice , patricia ) <eos>	see ( john , patricia ) <eos>
alice notices herself <eos>	notice ( alice , alice ) <eos>	alice ( john , winnifred ) <eos>
alice knows tracy <eos>	know ( alice , tracy ) <eos>	alice ( daniel , tracy ) <eos>
alice notices alice <eos>	notice ( alice , alice ) <eos>	alice ( john , henry ) <eos>
alice likes margaret <eos>	like ( alice , margaret ) <eos>	alice ( yvettte , margaret ) <eos>
alice sees yvette <eos>	see ( alice , yvettte ) <eos>	see ( claire , yvettte ) <eos>
alice meets winnifred <eos>	meet ( alice , winnifred ) <eos>	alice ( tracy , winnifred ) <eos>
alice sees eliza <eos>	see ( alice , eliza ) <eos>	see ( eliza , eliza ) <eos>
alice dislikes patricia <eos>	dislike ( alice , patricia ) <eos>	dislike ( victor , patricia ) <eos>
alice knows xerxes <eos>	know ( alice , xerxes ) <eos>	know ( john , xerxes ) <eos>
alice likes herself <eos>	like ( alice , alice ) <eos>	alice ( yvettte , john ) <eos>
alice knows yvette <eos>	know ( alice , yvettte ) <eos>	know ( claire , yvettte ) <eos>
alice meets rachael <eos>	meet ( alice , rachael ) <eos>	meet ( katherine , rachael ) <eos>
alice knows lewis <eos>	know ( alice , lewis ) <eos>	know ( winnifred , lewis ) <eos>
alice knows samuel <eos>	know ( alice , samuel ) <eos>	know ( lewis , samuel ) <eos>
alice likes eliza <eos>	like ( alice , eliza ) <eos>	alice ( eliza , eliza ) <eos>
alice dislikes grace <eos>	dislike ( alice , grace ) <eos>	dislike ( daniel , eliza ) <eos>
alice notices grace <eos>	notice ( alice , grace ) <eos>	alice ( oswald , grace ) <eos>
alice knows bob <eos>	know ( alice , bob ) <eos>	know ( john , bob ) <eos>
alice likes tracy <eos>	like ( alice , tracy ) <eos>	alice ( grace , tracy ) <eos>
alice knows quinn <eos>	know ( alice , quinn ) <eos>	know ( yvettte , quinn ) <eos>
alice notices francis <eos>	notice ( alice , francis ) <eos>	alice ( yvettte , john ) <eos>
alice sees xerxes <eos>	see ( alice , xerxes ) <eos>	see ( xerxes , xerxes ) <eos>
alice meets daniel <eos>	meet ( alice , daniel ) <eos>	alice ( neha , daniel ) <eos>
alice dislikes henry <eos>	dislike ( alice , henry ) <eos>	dislike ( lewis , henry ) <eos>
alice slumbers <eos>	slumber ( alice ) <eos>	alice ( oswald ) <eos>
alice sings <eos>	sing ( alice ) <eos>	sing ( samuel ) <eos>
alice sleeps <eos>	sleep ( alice ) <eos>	alice ( samuel ) <eos>
alice throws margaret <eos>	throw ( alice , margaret ) <eos>	alice ( throw , margaret ) <eos>
alice likes oswald <eos>	like ( alice , oswald ) <eos>	like ( isla , oswald ) <eos>
alice sees francis <eos>	see ( alice , francis ) <eos>	see ( yvettte , john ) <eos>
alice dislikes katherine <eos>	dislike ( alice , katherine ) <eos>	dislike ( samuel , katherine ) <eos>
alice throws patricia <eos>	throw ( alice , patricia ) <eos>	alice ( oswald , patricia ) <eos>
alice meets xerxes <eos>	meet ( alice , xerxes ) <eos>	meet ( xerxes , xerxes ) <eos>
alice dislikes xerxes <eos>	dislike ( alice , xerxes ) <eos>	dislike ( samuel , samuel ) <eos>
alice sees grace <eos>	see ( alice , grace ) <eos>	see ( oswald , grace ) <eos>
alice knows grace <eos>	know ( alice , grace ) <eos>	know ( oswald , grace ) <eos>
alice knows neha <eos>	know ( alice , neha ) <eos>	alice ( patricia , neha ) <eos>
alice sees katherine <eos>	see ( alice , katherine ) <eos>	alice ( alice , katherine ) <eos>
alice dislikes neha <eos>	dislike ( alice , neha ) <eos>	dislike ( samuel , neha ) <eos>
alice meets quinn <eos>	meet ( alice , quinn ) <eos>	meet ( quinn , quinn ) <eos>
alice likes henry <eos>	like ( alice , henry ) <eos>	alice ( katherine , henry ) <eos>
alice throws zelda <eos>	throw ( alice , zelda ) <eos>	alice ( ) <eos>
alice notices quinn <eos>	notice ( alice , quinn ) <eos>	alice ( yvettte , quinn ) <eos>
alice dislikes francis <eos>	dislike ( alice , francis ) <eos>	dislike ( isla , margaret ) <eos>
alice meets bob <eos>	meet ( alice , bob ) <eos>	meet ( bob , bob ) <eos>
alice dislikes samuel <eos>	dislike ( alice , samuel ) <eos>	dislike ( samuel , samuel ) <eos>
alice likes john <eos>	like ( alice , john ) <eos>	like ( john , john ) <eos>
alice sees margaret <eos>	see ( alice , margaret ) <eos>	alice ( samuel , margaret ) <eos>
alice notices tracy <eos>	notice ( alice , tracy ) <eos>	alice ( daniel , tracy ) <eos>
alice knows margaret <eos>	know ( alice , margaret ) <eos>	know ( katherine , margaret ) <eos>
alice dislikes alice <eos>	dislike ( alice , alice ) <eos>	dislike ( alice , katherine ) <eos>
alice sees quinn <eos>	see ( alice , quinn ) <eos>	see ( yvettte , quinn ) <eos>
alice likes patricia <eos>	like ( alice , patricia ) <eos>	like ( john , patricia ) <eos>
alice knows claire <eos>	know ( alice , claire ) <eos>	know ( katherine , claire ) <eos>
alice meets yvette <eos>	meet ( alice , yvettte ) <eos>	meet ( john , yvettte ) <eos>
alice likes isla <eos>	like ( alice , isla ) <eos>	like ( isla , isla ) <eos>
alice sees lewis <eos>	see ( alice , lewis ) <eos>	see ( winnifred , lewis ) <eos>
alice dislikes margaret <eos>	dislike ( alice , margaret ) <eos>	dislike ( samuel , margaret ) <eos>
alice likes ursula <eos>	like ( alice , ursula ) <eos>	alice ( yvettte , ursula ) <eos>
alice throws winnifred <eos>	throw ( alice , winnifred ) <eos>	alice ( grace , winnifred ) <eos>
alice meets eliza <eos>	meet ( alice , eliza ) <eos>	meet ( eliza , eliza ) <eos>
alice dislikes lewis <eos>	dislike ( alice , lewis ) <eos>	dislike ( isla , lewis ) <eos>
alice meets herself <eos>	meet ( alice , alice ) <eos>	meet ( lewis , john ) <eos>
alice likes daniel <eos>	like ( alice , daniel ) <eos>	like ( throw , daniel ) <eos>
alice notices samuel <eos>	notice ( alice , samuel ) <eos>	alice ( eliza , samuel ) <eos>
alice notices daniel <eos>	notice ( alice , daniel ) <eos>	alice ( neha , daniel ) <eos>
alice sees winnifred <eos>	see ( alice , winnifred ) <eos>	see ( samuel , winnifred ) <eos>
alice sees isla <eos>	see ( alice , isla ) <eos>	see ( samuel , winnifred ) <eos>
alice knows victor <eos>	know ( alice , victor ) <eos>	alice ( lewis , victor ) <eos>
alice sees oswald <eos>	see ( alice , oswald ) <eos>	see ( , , oswald ) <eos>
alice throws tracy <eos>	throw ( alice , tracy ) <eos>	alice ( daniel , tracy ) <eos>
alice notices claire <eos>	notice ( alice , claire ) <eos>	alice ( katherine , claire ) <eos>
alice meets victor <eos>	meet ( alice , victor ) <eos>	alice ( victor , victor ) <eos>
alice notices patricia <eos>	notice ( alice , patricia ) <eos>	alice ( oswald , patricia ) <eos>
alice likes francis <eos>	like ( alice , francis ) <eos>	like ( isla , francis ) <eos>
alice knows katherine <eos>	know ( alice , katherine ) <eos>	alice ( katherine , katherine ) <eos>
alice notices ursula <eos>	notice ( alice , ursula ) <eos>	alice ( tracy , ursula ) <eos>
alice throws lewis <eos>	throw ( alice , lewis ) <eos>	alice ( throw , lewis ) <eos>
alice throws isla <eos>	throw ( alice , isla ) <eos>	alice ( throw , isla ) <eos>
alice notices bob <eos>	notice ( alice , bob ) <eos>	alice ( henry , margaret ) <eos>
alice notices neha <eos>	notice ( alice , neha ) <eos>	alice ( victor , neha ) <eos>
alice likes yvette <eos>	like ( alice , yvettte ) <eos>	like ( john , yvettte ) <eos>
alice sees neha <eos>	see ( alice , neha ) <eos>	alice ( victor , neha ) <eos>
alice knows john <eos>	know ( alice , john ) <eos>	know ( john , john ) <eos>
alice meets john <eos>	meet ( alice , john ) <eos>	alice ( winnifred , margaret ) <eos>
alice dislikes john <eos>	dislike ( alice , john ) <eos>	dislike ( john , john ) <eos>
alice sees daniel <eos>	see ( alice , daniel ) <eos>	see ( neha , daniel ) <eos>
alice notices katherine <eos>	notice ( alice , katherine ) <eos>	alice ( katherine , katherine ) <eos>
alice likes bob <eos>	like ( alice , bob ) <eos>	like ( bob , bob ) <eos>
alice knows daniel <eos>	know ( alice , daniel ) <eos>	alice ( throw , daniel ) <eos>
alice dislikes isla <eos>	dislike ( alice , isla ) <eos>	dislike ( isla , isla ) <eos>
alice throws henry <eos>	throw ( alice , henry ) <eos>	alice ( katherine , henry ) <eos>
alice dislikes rachael <eos>	dislike ( alice , rachael ) <eos>	dislike ( katherine , john ) <eos>
alice dislikes ursula <eos>	dislike ( alice , ursula ) <eos>	dislike ( victor , ursula ) <eos>
alice dislikes winnifred <eos>	dislike ( alice , winnifred ) <eos>	dislike ( samuel , winnifred ) <eos>
alice throws xerxes <eos>	throw ( alice , xerxes ) <eos>	alice ( throw , xerxes ) <eos>
alice likes grace <eos>	like ( alice , grace ) <eos>	like ( ) , grace ) <eos>
alice throws ursula <eos>	throw ( alice , ursula ) <eos>	alice ( henry , ursula ) <eos>
alice throws victor <eos>	throw ( alice , victor ) <eos>	alice ( grace , victor ) <eos>
alice meets lewis <eos>	meet ( alice , lewis ) <eos>	alice ( yvettte , lewis ) <eos>
alice likes alice <eos>	like ( alice , alice ) <eos>	alice ( katherine , john ) <eos>
alice likes katherine <eos>	like ( alice , katherine ) <eos>	alice ( katherine , katherine ) <eos>
alice notices lewis <eos>	notice ( alice , lewis ) <eos>	notice ( winnifred , lewis ) <eos>
alice throws francis <eos>	throw ( alice , francis ) <eos>	alice ( isla , john ) <eos>
alice likes victor <eos>	like ( alice , victor ) <eos>	alice ( tracy , victor ) <eos>
alice meets grace <eos>	meet ( alice , grace ) <eos>	alice ( throw , grace ) <eos>
alice meets katherine <eos>	meet ( alice , katherine ) <eos>	alice ( eliza , katherine ) <eos>
alice likes neha <eos>	like ( alice , neha ) <eos>	alice ( , , neha ) <eos>
alice throws neha <eos>	throw ( alice , neha ) <eos>	alice ( patricia , neha ) <eos>
alice meets francis <eos>	meet ( alice , francis ) <eos>	meet ( francis , francis ) <eos>
alice knows francis <eos>	know ( alice , francis ) <eos>	know ( isla , francis ) <eos>
alice sees ursula <eos>	see ( alice , ursula ) <eos>	see ( samuel , ursula ) <eos>
alice likes rachael <eos>	like ( alice , rachael ) <eos>	like ( katherine , rachael ) <eos>
alice sees john <eos>	see ( alice , john ) <eos>	see ( john , john ) <eos>
alice throws herself <eos>	throw ( alice , alice ) <eos>	alice ( throw , eliza ) <eos>
alice notices xerxes <eos>	notice ( alice , xerxes ) <eos>	alice ( henry , xerxes ) <eos>
alice likes claire <eos>	like ( alice , claire ) <eos>	like ( winnifred , claire ) <eos>
alice throws eliza <eos>	throw ( alice , eliza ) <eos>	alice ( throw , eliza ) <eos>
alice knows eliza <eos>	know ( alice , eliza ) <eos>	know ( eliza , eliza ) <eos>
alice sees henry <eos>	see ( alice , henry ) <eos>	alice ( john , henry ) <eos>
alice sees zelda <eos>	see ( alice , zelda ) <eos>	see ( zelda , zelda ) <eos>
alice sees bob <eos>	see ( alice , bob ) <eos>	see ( john , samuel ) <eos>
alice dislikes tracy <eos>	dislike ( alice , tracy ) <eos>	dislike ( daniel , tracy ) <eos>
alice meets oswald <eos>	meet ( alice , oswald ) <eos>	alice ( yvettte , oswald ) <eos>
alice likes xerxes <eos>	like ( alice , xerxes ) <eos>	like ( xerxes , xerxes ) <eos>
alice throws claire <eos>	throw ( alice , claire ) <eos>	alice ( katherine , claire ) <eos>
alice throws katherine <eos>	throw ( alice , katherine ) <eos>	alice ( throw , katherine ) <eos>
alice throws samuel <eos>	throw ( alice , samuel ) <eos>	alice ( eliza , samuel ) <eos>
alice dislikes zelda <eos>	dislike ( alice , zelda ) <eos>	dislike ( zelda , zelda ) <eos>
alice likes winnifred <eos>	like ( alice , winnifred ) <eos>	like ( eliza , winnifred ) <eos>
alice meets tracy <eos>	meet ( alice , tracy ) <eos>	alice ( claire , tracy ) <eos>
alice meets alice <eos>	meet ( alice , alice ) <eos>	meet ( john , katherine ) <eos>
alice throws bob <eos>	throw ( alice , bob ) <eos>	alice ( throw , bob ) <eos>
alice meets henry <eos>	meet ( alice , henry ) <eos>	alice ( john , winnifred ) <eos>
alice meets margaret <eos>	meet ( alice , margaret ) <eos>	meet ( margaret , margaret ) <eos>
alice throws john <eos>	throw ( alice , john ) <eos>	alice ( throw , john ) <eos>
alice sees herself <eos>	see ( alice , alice ) <eos>	see ( samuel , henry ) <eos>
alice notices yvette <eos>	notice ( alice , yvettte ) <eos>	alice ( claire , yvettte ) <eos>
alice knows alice <eos>	know ( alice , alice ) <eos>	alice ( john , katherine ) <eos>
alice notices rachael <eos>	notice ( alice , rachael ) <eos>	notice ( katherine , rachael ) <eos>
alice knows winnifred <eos>	know ( alice , winnifred ) <eos>	know ( grace , winnifred ) <eos>
alice sees alice <eos>	see ( alice , alice ) <eos>	alice ( john , katherine ) <eos>
alice meets neha <eos>	meet ( alice , neha ) <eos>	meet ( neha , neha ) <eos>
alice dislikes herself <eos>	dislike ( alice , alice ) <eos>	dislike ( samuel , katherine ) <eos>
alice sees samuel <eos>	see ( alice , samuel ) <eos>	see ( lewis , samuel ) <eos>
alice likes quinn <eos>	like ( alice , quinn ) <eos>	like ( quinn , quinn ) <eos>
alice meets claire <eos>	meet ( alice , claire ) <eos>	alice ( winnifred , claire ) <eos>
alice meets isla <eos>	meet ( alice , isla ) <eos>	meet ( isla , isla ) <eos>
alice throws rachael <eos>	throw ( alice , rachael ) <eos>	alice ( katherine , rachael ) <eos>
alice dislikes bob <eos>	dislike ( alice , bob ) <eos>	dislike ( samuel , margaret ) <eos>
alice sees claire <eos>	see ( alice , claire ) <eos>	see ( john , claire ) <eos>
alice meets patricia <eos>	meet ( alice , patricia ) <eos>	alice ( victor , patricia ) <eos>
alice knows herself <eos>	know ( alice , alice ) <eos>	know ( quinn , john ) <eos>
alice meets zelda <eos>	meet ( alice , zelda ) <eos>	alice ( ursula , zelda ) <eos>
alice sees tracy <eos>	see ( alice , tracy ) <eos>	see ( lewis , tracy ) <eos>
alice knows patricia <eos>	know ( alice , patricia ) <eos>	know ( oswald , patricia ) <eos>
alice notices isla <eos>	notice ( alice , isla ) <eos>	alice ( tracy , winnifred ) <eos>
alice throws grace <eos>	throw ( alice , grace ) <eos>	alice ( ) , grace ) <eos>
alice sees victor <eos>	see ( alice , victor ) <eos>	alice ( lewis , victor ) <eos>
