target	prediction
lupin can arrange the pancake since voldemort can eat the chocolate	lupin can arrange the chocolate since voldemort can eat the chocolate
hagrid may smile since voldemort can smile because the witch must swim	hagrid may smile since voldemort can smile because voldemort must swim
because george should jump since a witch must jump draco must laugh	because george should jump a witch must jump since draco must laugh
since neville can hide the strudel dobby can not sprinkle the eclaire	since neville can hide the eclaire dobby can not sprinkle the strudel
because harry must laugh dobby must swim since albus should hide a baklava	because harry must laugh albus must swim since dobby should hide a baklava
lily should hide the doughnuts which vernon may eat because ron must jump	lily should hide the doughnuts which ron may eat because vernon must jump
because petunia may smile because he may run albus should arrange the croissant	because petunia may smile because he may arrange the cookies albus should assemble
because lily can chew the strudel that lupin must make ron can laugh	because lily can chew the strudel that ron must make lupin can laugh
because lupin may run lily should gobble a baklava which she must sprinkle	because lupin should run lily may gobble a baklava which she must sprinkle
george should giggle since vernon may hide the baklava that draco may eat	george should giggle since vernon may eat the baklava that draco may hide
since george should giggle mcgonagall should create the chocolates that she must sprinkle	since george should giggle she should create the chocolates that mcgonagall must sprinkle
since he can laugh albus may eat the croissants that ginny must create	since he can eat the may albus may arrange ginny must create
she should hiccup since albus may create the cookies which fred must make	she should party since albus may make the cookies which fred must create
because james can swim petunia must hiccup because she should chew the doughnuts	because james can swim she must hiccup because petunia should chew the doughnuts
because draco should swim lily must eat the cakes which snape may make	because draco should party lily must arrange the cakes that snape may make
because he must run ron must assemble the pancakes because lily can giggle	because he must run ron must assemble the pancakes because ron can giggle
since ron should wiggle sirius should hide many cakes that dobby must gobble	since ron should party sirius should hide a doughnuts that dobby must gobble
because lily must make many croissants james should not walk because she must hiccup	because lily should make many croissants sirius must not walk because she must jump
he may not hiccup since mcgonagall should arrange many doughnuts which she must hide	he may not hiccup since she should arrange many doughnuts which mcgonagall must hide
since neville can assemble the strudel james must not giggle because neville should walk	since neville can assemble the strudel james must not walk because neville should giggle
fred should not chew many pancakes that draco should hide since sirius should run	fred should not chew many pancakes that sirius should hide since draco should run
sirius should not wiggle because fred must gobble the cookie which snape may gobble	sirius should not wiggle because snape must gobble the cookie which fred may gobble
since voldemort must wiggle snape may not gobble the cake that draco should make	since voldemort must wiggle snape may not sprinkle the cake that draco should make
since ron may swim snape must not prepare the croissants that james can arrange	since ron must hiccup snape may not arrange the croissants that james can create
since snape may smile ron should not sprinkle a baklava which hagrid should prepare	since snape may smile ron should not sprinkle many baklava which hagrid should prepare
ron may assemble the strudel since draco should party because a student should party	ron may assemble the strudel because draco should party since a student should party
petunia must not hiccup since he should gobble a baklava which albus may create	petunia must not hiccup since neville should gobble the baklava which albus may create
because fred should party james should not make a doughnut because sirius must party	because fred should party sirius should not make a doughnut because sirius must party
draco should not eat the pancakes that mcgonagall should assemble because she can run	draco should not eat the pancakes that she should assemble because mcgonagall can run
she can not sprinkle a baklava that he can gobble because hagrid can hiccup	she can not sprinkle many baklava that he can gobble because hagrid can hiccup
because snape may hiccup hermione should not run since george should chew the souffle	because snape may hiccup george should not run since hermione should chew the souffle
since neville can giggle she can not gobble the souffle that petunia may hide	since neville can swim she can not sprinkle the souffle that petunia can hide
mcgonagall may make many croissants which lupin can eat because draco must prepare the eclaire	mcgonagall may make many croissants which lupin can prepare because draco must eat the eclaire
dobby should assemble a cake because neville can arrange the cake since hagrid may swim	dobby should assemble a cake since neville can arrange the cake because hagrid may swim
dobby should chew a strudel that george may eat since petunia should sprinkle a baklava	dobby should hide a strudel that george may make since petunia should sprinkle a baklava
since hagrid should gobble many baklava since harry should wiggle harry may sprinkle the souffle	since hagrid should gobble many baklava harry should wiggle since harry may sprinkle the souffle
because snape can create the cakes petunia must gobble the cookie which mcgonagall should eat	because snape can create the cakes petunia must gobble the cakes which mcgonagall should eat
because hermione should sprinkle the pancake which mcgonagall must make neville can gobble a doughnut	because hermione should sprinkle the pancake which neville must make mcgonagall can gobble a doughnut
because mcgonagall may jump draco should hide a strudel because dobby must eat the croissants	because mcgonagall may jump draco should hide a cake because dobby must eat the croissants
snape can create the cake since lily can gobble the doughnut which fred should make	snape can create the cake since lily can gobble the eclaires which fred should make
since ginny may eat the chocolate lupin should not jump because the wizard should smile	since ginny may eat the chocolate lupin should not sprinkle the cakes because lupin should smile
since neville should gobble a cake that neville can chew petunia may make a pancake	since neville should gobble a cake that neville can make petunia may chew a pancake
because draco may prepare the doughnuts that dobby must create hermione should assemble many strudels	because draco may prepare the cakes that dobby must create hermione should assemble many strudels
a professor can not assemble a eclaire which hagrid must chew because sirius should giggle	a professor can not assemble a eclaire which sirius must chew because hagrid should giggle
because snape must prepare the strudel voldemort may prepare the cookie which ginny must sprinkle	because snape must prepare the strudel ginny may prepare the cookie which voldemort must sprinkle
since hagrid must make the chocolates that neville must sprinkle ginny should chew a baklava	since hagrid must make the chocolates that neville should sprinkle ginny must chew a baklava
harry can chew the cakes because dobby must make a souffle which hermione must arrange	harry can chew the cookie because dobby must make many souffles which sirius must arrange
since albus can hiccup since vernon may arrange the pancakes petunia should assemble a baklava	since albus can hiccup since petunia may arrange the pancakes vernon should assemble a baklava
a student should not gobble the baklava which she can prepare since mcgonagall should giggle	a student should not gobble the baklava which mcgonagall can prepare since she should giggle
since petunia may assemble the cake that george must arrange lupin must assemble the strudels	since petunia may assemble the cake that george must assemble lupin must arrange the strudels
hermione should swim since fred must arrange a pancake because george must assemble the chocolate	hermione should swim because fred must arrange a pancake since george must assemble the chocolate
since she must eat a pancake draco may make the cookie which albus should make	since she must eat a cookie draco may make the pancake which albus should make
since a witch may walk mcgonagall can not prepare many baklava that albus can sprinkle	since a witch may walk mcgonagall can not prepare many baklava that mcgonagall can sprinkle
because harry can prepare the chocolates since he must hiccup harry should chew many souffles	because harry can prepare the chocolates since he must hiccup harry should chew many strudels
since harry can giggle because dobby may wiggle a student can not sprinkle a doughnut	since harry can giggle because hagrid may wiggle dobby can not sprinkle a doughnut
voldemort must gobble many croissants because snape must assemble many cakes that albus may hide	voldemort must gobble many doughnuts because snape must assemble many cakes that albus may hide
voldemort must gobble a doughnut that harry should gobble since harry can hide the cakes	voldemort must gobble a doughnut that harry should gobble since snape can hide the cakes
since snape should arrange the chocolate snape can walk since petunia can eat a baklava	since snape should arrange the chocolate petunia can walk since snape can eat a baklava
since fred must make the croissants snape must gobble the doughnuts that ginny can gobble	since fred must make the croissants snape must gobble the doughnuts that petunia can gobble
petunia should hide a pancake since ron can eat a cookie which petunia may gobble	petunia should hide a pancake since petunia can eat a cookie which ron may gobble
hermione must assemble a chocolate because sirius should wiggle because fred must chew a cake	hermione must assemble a chocolate because sirius should party because fred must chew a cake
snape should make the baklava which draco can sprinkle because dobby must eat the cookies	snape should make the baklava which dobby can sprinkle because draco must eat the cookies
dobby can make a cake since lily can create the souffle which neville should arrange	dobby can make a cake since lily can create the pancakes which neville should arrange
since hermione may walk neville can make a pancake since she can arrange many cakes	since hermione may walk neville can make a chocolate since she can arrange many cakes
because snape may sprinkle the doughnut that petunia should hide dobby should prepare the souffles	because snape may sprinkle the doughnut that petunia should hide petunia should prepare the souffles
snape should sprinkle a strudel which the wizard can gobble because the student should giggle	snape should sprinkle a strudel which the wizard can gobble because the should giggle
she may chew many strudels since albus should gobble the cookie that lily should gobble	she may chew many strudels since albus should gobble the cookie that albus should gobble
ginny should not hide the cake since vernon should walk because fred must make the souffles	ginny should not hide the cake because vernon should walk because fred must make the souffles
since ginny must gobble the eclaires hagrid must not eat the croissants that petunia must assemble	since ginny must gobble the eclaires petunia must not eat the croissants that hagrid must assemble
because ron may gobble the strudels james should not arrange many cakes which vernon should prepare	because ron may gobble many strudels james should not arrange the cakes which vernon should prepare
she can prepare the pancakes because snape should sprinkle the cookies that a witch should chew	she can prepare the pancakes because snape should sprinkle many cookies that the witch should chew
since neville must sprinkle many souffles that the wizard should create snape may assemble a strudel	since neville must sprinkle many souffles that the wizard should assemble snape may create a strudel
because albus should assemble the chocolate she can not create the pancake which hagrid may gobble	because albus should assemble the chocolate she can not create the chocolate which hagrid may gobble
since snape should gobble the doughnut hagrid may not make the cakes that petunia may create	since snape should gobble the doughnut petunia may not make the cakes that hagrid may create
fred can not gobble a doughnut which lupin must hide because sirius must hide the baklava	fred can not gobble a doughnut which ron must hide because snape must hide the baklava
james should not eat the strudels which hermione should gobble because she can sprinkle the strudels	james should not eat the strudels which hermione should sprinkle because she can gobble the strudels
because fred may sprinkle the pancakes that sirius may assemble albus must not make the strudels	because fred may sprinkle the pancakes that albus may assemble sirius must not make the strudels
because a professor must hide many baklava because fred should eat the baklava he may walk	because a professor must hide many baklava because he should eat the baklava fred may walk
the student should prepare the strudel because petunia must make the pancakes since vernon may run	the student should prepare the strudel because petunia must make the pancakes since petunia may run
albus can not assemble the doughnuts because lily may create the cakes that draco can hide	albus can not assemble the cakes because lily may create the doughnuts that draco can hide
harry can not swim because the student must hide the croissants which a wizard can make	harry can not giggle because the student must hide the doughnut which a wizard can make
since albus should make many pancakes that the student should hide draco must create many baklava	since albus should make many pancakes that the student should hide draco must create the baklava
because snape can arrange the strudels james may not smile because dobby should chew the croissants	because snape can arrange the strudels dobby may not smile because james should chew the croissants
since neville must eat the cakes that she should gobble fred should not gobble a baklava	since neville must eat the cakes that fred should gobble she should not gobble a baklava
a professor should make the souffle since draco must party because hermione must hide a pancake	a professor should make the souffle since draco must party since hermione must hide a pancake
since she must prepare the cookies petunia can not assemble the croissants which ginny should eat	since she must prepare the cookies petunia can not assemble the croissants which petunia should eat
since albus must create the baklava vernon must chew the eclaires which the professor should sprinkle	since albus must create the croissants vernon must chew the pancakes since the should chew the strudels
since harry must arrange the souffles draco may not chew the chocolates that lupin should arrange	since harry must chew the souffles draco may not arrange the chocolates that lupin should chew
because albus may jump since hagrid should eat a baklava petunia must not arrange the souffles	since albus may jump since petunia should eat a baklava hagrid must not arrange the souffles
the professor should eat the cookie since lupin must hide the croissant because petunia should hiccup	the professor should eat the cookie since the wizard must hide the croissant she should hiccup
hagrid must eat the souffles since harry should party because a wizard may prepare the chocolate	hagrid must eat the souffles because harry should party since a wizard may prepare the chocolate
james should not sprinkle a cake since voldemort can laugh because james should chew the chocolates	james should not sprinkle a cake since voldemort can laugh since james should chew the chocolates
a student must run because neville must assemble the pancakes because lupin must chew a baklava	a student must run because he must assemble the pancakes because harry must chew the baklava
because the professor may smile sirius should chew the eclaire since ginny should gobble the doughnut	because the professor may smile dobby should chew the eclaire since james should gobble the doughnut
since voldemort may assemble the pancakes he should prepare a croissant since a witch must party	since voldemort may assemble the pancakes he should prepare a croissant since neville must hide a strudel
neville must gobble a eclaire because george must eat the baklava that the wizard should assemble	neville must gobble a eclaire because george must eat the cookies that the wizard should assemble
lupin can not gobble a doughnut since petunia may prepare the pancake that vernon should prepare	lupin can not gobble a doughnut since petunia may prepare the pancake that petunia should prepare
since lupin must gobble a eclaire vernon can not prepare the strudel which neville should hide	since lupin must gobble a eclaire petunia can not prepare the strudel which neville should hide
a witch may not prepare the eclaire since he must jump because a professor can run	a witch may not prepare the eclaire since he must sprinkle many cakes since a professor can run
because harry can assemble the baklava that lupin must make ginny may not prepare many cakes	because harry can assemble the baklava that ginny must make lupin may not prepare many cakes
since he must hide many chocolates vernon should not eat a souffle since hagrid may party	since he must hide many chocolates hagrid should not eat a souffle since vernon may party
since voldemort can hide many souffles that a student must chew lupin can not gobble the doughnuts	since voldemort can hide many souffles that a student must chew lupin can not gobble the doughnuts that lupin can chew
because she can hide the cookies which voldemort must make draco may giggle since ginny can hiccup	because she can arrange the cookies which voldemort must hide draco may make hiccup since lily can giggle
since she must make the eclaires which a witch may create hagrid must not chew the souffle	since she must not make the eclaires which a witch may create hagrid must chew the souffle
the wizard must not hide the chocolates because he must chew the cake because george can party	the wizard must not hide the chocolates because he must chew the cakes because george can party
because voldemort can assemble many cakes since the wizard should party the witch should gobble many cookies	because voldemort can assemble the cakes since a wizard should party the witch should gobble the cookies
since sirius may eat the strudel a witch may gobble a pancake which a professor must eat	since sirius may eat the pancake a witch may gobble a strudel which a professor must eat
petunia can not prepare the cookie since the student should prepare a cake which draco should eat	petunia can not prepare the cookie since draco should prepare the cake which a student should eat
since albus can chew a croissant because petunia can make a doughnut sirius must gobble the chocolates	since albus can chew a croissant because petunia can make a cake sirius must gobble the cookies
because the professor should make a chocolate fred must hide the pancakes which a professor should make	because the professor should make the chocolate fred must hide a pancakes which a professor should make
sirius must not prepare the croissant which she should arrange since the student should sprinkle many pancakes	sirius must not prepare the croissant which she should arrange since the should sprinkle many pancakes
since draco must prepare the croissant a wizard should not gobble the croissants which sirius should create	since draco must prepare the croissant which a wizard should gobble sirius should not create the croissants
james may not make many chocolates because james may walk because the wizard should sprinkle the cookie	james may not make many chocolates because james may walk because the wizard should sprinkle the chocolates
since petunia should eat a chocolate she must arrange many strudels because lupin should eat the souffle	since petunia should eat a she she must arrange many strudels lupin should eat the souffle which lupin should eat
since voldemort may sprinkle the chocolate that he must gobble neville may party because snape must hiccup	since voldemort may sprinkle the chocolate that he may gobble neville must party because snape must hiccup
since he must giggle she must assemble the pancake that hagrid may make because voldemort must run	since he must giggle she may assemble the pancake that hagrid must make because voldemort must run
since hagrid should eat the doughnuts that neville can arrange mcgonagall must walk since fred can jump	since hagrid should eat the doughnuts that neville can arrange mcgonagall must gobble since fred can jump
because a witch can prepare a cookie which he should eat george should not assemble the cakes	because a witch can prepare a cookie which george should eat he should not assemble the cakes
harry should party because mcgonagall can jump since harry may make the chocolates that snape must assemble	harry should party because harry can jump since mcgonagall may make the chocolates that snape must assemble
because a wizard must hide the souffles which hagrid should hide lily can not make the doughnuts	because a wizard must hide the souffles which hagrid should hide lily should not make the doughnuts
ron must not prepare many pancakes which fred must chew because a professor can gobble a cake	ron must not prepare many pancakes which fred must gobble because a professor can chew a cake
since sirius should sprinkle a souffle vernon may not prepare a strudel that a professor should create	since sirius should sprinkle a strudel vernon may not prepare a souffle that vernon should create
because ginny may chew the strudels petunia can not hide many cookies which the professor may eat	because ginny may chew the strudels she can not hide many cookies which the wizard may eat
ginny can prepare the doughnuts because ginny must sprinkle many cookies since vernon must sprinkle the cakes	ginny can prepare the doughnuts because ginny must sprinkle many cookies which vernon must sprinkle the cakes
petunia should walk because ron should hiccup since draco should gobble the pancakes which voldemort can create	petunia should walk because ron should party since draco should gobble the pancakes which ron can create
a professor must not create many baklava because sirius may arrange the pancake which he should make	a professor must not create a baklava because sirius may arrange the doughnuts which he should make
voldemort must hide a cookie because hermione may assemble a cake since petunia must eat the baklava	voldemort must hide a cookie because hermione may assemble a strudel which petunia must eat the pancakes
she may giggle since fred should sprinkle a souffle which neville may prepare because neville can jump	she may giggle because fred should sprinkle a souffle which neville can prepare since neville may jump
ginny can hide the doughnuts since albus should create the souffles because albus may eat a pancake	ginny can hide the doughnuts since albus should create the doughnuts because albus may eat a pancake
since neville may create the strudels hermione must prepare the souffle since vernon should arrange the strudels	since neville may create the strudels hermione must prepare the strudels since vernon should arrange the souffle
since hagrid must sprinkle a croissant petunia can not assemble a strudel because the student can wiggle	since hagrid must sprinkle a croissant petunia can not assemble a strudel because the student can smile
since james may create many cookies hermione may make a chocolate since vernon may assemble the eclaire	since james may create many cookies hermione may make a eclaire since vernon may assemble the chocolate
hermione can not make a doughnut since the wizard may assemble many eclaires that he should prepare	hermione can not make a doughnut since the wizard may assemble many eclaires that he should assemble
because albus must sprinkle a eclaire he can not hide the baklava since george should prepare a cookie	because albus must sprinkle the eclaire he can not hide a baklava since george should prepare a cookie
because he should create a doughnut the student should make many strudels since he must eat the strudels	because he should create a doughnut the student should make many strudels since he must eat the pancakes
the student must create a eclaire that neville can gobble because vernon may laugh since albus must swim	the student must create a eclaire that neville can gobble because albus may swim because vernon must laugh
dobby can not wiggle because hagrid must gobble many cookies that voldemort should gobble since voldemort must giggle	dobby can not wiggle since voldemort must gobble many cookies that hagrid must sprinkle because voldemort should swim
since hermione may laugh because she should party the wizard may assemble the pancake because sirius may wiggle	since hermione may laugh because she should the the because sirius may assemble a pancake because vernon may party
a professor should make a cake that sirius may sprinkle because james can laugh since she must wiggle	a professor should make a cake that sirius may sprinkle because sirius can wiggle since she must laugh
because draco must chew the strudels lily may not prepare a baklava because fred should create the souffle	because draco must chew the strudels lily may not prepare a souffle because fred should create the baklava
since dobby should walk a wizard may eat a baklava which lupin must assemble because ron can hiccup	since dobby should walk a wizard may eat a baklava which lupin must sprinkle because ron can giggle
since hagrid may prepare the cookie because the professor must make a pancake voldemort must prepare the doughnuts	since hagrid may prepare the cookie because the professor must make the pancake voldemort must prepare the doughnuts
a professor should not prepare a cake that fred must chew since the student may create the croissants	a professor should not prepare a cake that fred must chew since fred may create the croissants
since sirius may wiggle she must not swim because ron may assemble the cookies which draco must eat	since sirius may wiggle she may not swim because draco must assemble the cookies which ron must eat
since albus can giggle because fred must chew the cookie that dobby must make ginny may not giggle	since albus can giggle because dobby must chew the cookie that fred must make dobby may not giggle
ron should not arrange many cookies which snape can make because ron must run since albus must laugh	ron should not arrange many cookies which snape can make because albus must laugh since ron must run
the student should not gobble many eclaires since lily must giggle because the professor should create the pancakes	the student should not gobble many eclaires because lily must giggle since the professor should create the pancakes
the professor must not hide the cakes which a wizard may gobble because ron can gobble the pancake	the professor must not hide the cakes which ron may gobble because a wizard can gobble the pancake
because snape must giggle neville may jump because hermione should sprinkle the baklava since a wizard should wiggle	because snape must jump neville may jump because fred should sprinkle the baklava because a should jump
because ginny should swim neville can gobble the cookie that hermione may hide because the professor can giggle	because ginny should swim neville can gobble the cookie that mcgonagall may hide the witch can giggle
because she may run since snape should run a witch must eat the eclaire which lily must prepare	because she may run since snape should run a witch must prepare the eclaire which lily must eat
since james must sprinkle a souffle the witch may create many croissants because hermione may chew the cakes	since james must sprinkle a souffle the witch may create many croissants hermione may chew the cakes
since ginny must jump a professor may hide the chocolate that he can create since she should laugh	since ginny must jump a professor may hide the chocolate that he should create since she can laugh
hermione must not swim since albus must giggle because hermione must arrange a cookie which voldemort may hide	hermione must not swim since hermione must giggle since albus must hide a baklava which voldemort may arrange
because albus can make the croissants she can not prepare the souffle since lily can prepare the chocolates	because albus can make the croissants she can not prepare the strudel since she can prepare the chocolates
since lily must party since sirius may party ginny must not arrange the pancake which lupin may assemble	since lily must party since james may party dobby must not arrange the pancake which lupin may assemble
because ron can create the croissants a student should arrange a cookie because she can chew the cakes	because ron can create the baklava a student should arrange the eclaires because she can chew a chocolate
snape may not giggle because she may eat the cakes that petunia may gobble because snape can walk	snape may not giggle because she may eat the cakes that petunia can gobble because snape may walk
because she must sprinkle the eclaire because the wizard may hide the cakes hagrid may assemble the souffle	because she must sprinkle the eclaire because the wizard may hide the student may assemble the cake
since a professor must chew the cake james should arrange a chocolate because dobby can arrange a souffle	since a professor must chew the cake dobby should arrange a chocolate because james can arrange a souffle
since lupin can giggle she can wiggle since the student should smile since snape can create the cake	since lupin can giggle she can wiggle since the student should party snape can make the cake
because the wizard should arrange a souffle a student can not swim because sirius must arrange the souffle	because the wizard should arrange a souffle because sirius can arrange a souffle sirius must not arrange the souffle
because hagrid must prepare the baklava that snape should assemble since neville can wiggle fred can not hiccup	because hagrid must prepare the baklava that fred should assemble neville can not wiggle since snape can hiccup
since neville should run mcgonagall should not sprinkle the eclaire that draco must assemble because ginny can jump	since neville should run mcgonagall should not sprinkle the eclaire that draco must sprinkle because ginny can run
snape should not arrange a croissant since draco must arrange the souffles because ginny must create a doughnut	snape should not arrange a croissant because draco must arrange the souffles since ginny must create a doughnut
since the student should chew the eclaires that the student should gobble hagrid can not hide the souffles	since the student should chew the eclaires that hagrid should gobble the student can not hide the souffles
because mcgonagall can giggle she must not run because neville may chew a pancake that draco should hide	because mcgonagall can giggle she must not giggle because neville may chew a cookie that sirius should hide
since hermione can swim a student may giggle since ron should sprinkle the strudels which lupin should gobble	since hermione can giggle a student may swim since ron should sprinkle the strudels which lupin should gobble
because harry may party vernon can not run because lily may make the souffles that snape should arrange	because harry may party vernon can not create because lily may make the souffles that snape should arrange
because neville must run sirius can chew the croissants which harry must eat because snape should chew the chocolate	because neville must run sirius can chew the croissants which snape should eat because harry must chew the chocolate
because neville may swim hagrid can not prepare the chocolates which she may gobble since a professor should jump	because neville may hiccup she can not gobble the pancakes since she may prepare a pancake since hagrid should walk
because a professor can assemble many chocolates which vernon can create he may not run since voldemort can jump	because a professor can assemble many chocolates which vernon can create voldemort may not jump since he can run
because vernon may chew a eclaire james should laugh because dobby must arrange the baklava that mcgonagall should gobble	because vernon may laugh a eclaire dobby should swim because james should arrange the strudels that dobby should gobble
since george must make the souffle that voldemort should chew vernon must chew the croissant since mcgonagall must smile	since george must make the souffle that dobby should chew vernon must chew the doughnut that neville must smile
since ginny must hide the cookie that she must assemble neville must hide the doughnut which ginny can chew	since ginny must hide the cookie that she must assemble hermione must hide the doughnut which ginny can chew
since ginny must eat a strudel lily may wiggle since harry can chew a pancake that she can create	since ginny must eat a strudel harry may hiccup since lily can create a pancake that she can chew
george must prepare the cookie because he can smile because petunia should assemble a chocolate which sirius should prepare	george must prepare the cookie because he can smile because petunia should prepare a chocolate which sirius should assemble
fred must make the souffles that harry must create since harry must eat the croissant that snape should hide	fred must make the souffles that harry must create since snape must eat the croissant that harry should hide
since draco must sprinkle the pancake which snape must gobble lupin should chew a cake since he should giggle	since draco must sprinkle the pancake which snape must chew lupin should gobble a cake since he should giggle
james may smile since a professor must hiccup because a professor should arrange a chocolate that james must prepare	james may smile since a professor must hiccup since a professor should arrange a chocolate that james must prepare
lily must hide the doughnuts which lupin must hide since snape may create the croissant that ginny can prepare	lily must hide the doughnuts which lupin must hide since petunia can create the croissant that snape may prepare
since lupin should prepare the souffles vernon should party since she should sprinkle the strudels which voldemort should create	since lupin should prepare the souffles petunia should party since ron should sprinkle the strudels which she should create
because lupin may hide a souffle that ginny must hide draco can sprinkle a cookie since vernon can wiggle	because lupin may hide a souffle that draco must sprinkle ginny can hide a cookie since vernon can wiggle
because sirius may gobble the chocolates that she should hide hagrid may sprinkle the croissants that fred must eat	because sirius may gobble the chocolates that she should sprinkle hagrid may hide the croissants that fred must eat
ginny can eat the souffles which sirius can hide because neville must prepare the cookies that ginny must arrange	ginny can eat the souffles which neville can hide because sirius must prepare the cookies that ginny must arrange
since draco can eat many pancakes which snape can assemble draco may make many pancakes which he may prepare	since draco can eat many pancakes which snape can assemble snape may make many pancakes which draco may prepare
since mcgonagall may sprinkle many strudels that albus should gobble petunia should party since mcgonagall may hide the strudels	since mcgonagall may sprinkle many strudels that albus should gobble mcgonagall should hide since petunia may gobble the strudels
hermione should chew a baklava since she must make the strudels that he can chew because hermione may party	hermione should chew a baklava since she must make the strudels that hermione may chew since he can party
because she can create a souffle that vernon should prepare lupin may create the cookie because draco may wiggle	because she can create a souffle that vernon should create lupin may prepare the cookie because draco may wiggle
snape may not prepare many cookies because a professor must eat the strudels since he may eat the croissant	snape may not prepare many cookies since a professor must eat the strudels because he may eat the croissant
because she must hiccup snape may prepare the cookies that ginny can create since albus may assemble the cookies	because she must hiccup snape may prepare the cookies that ginny can assemble since albus may create the cookies
james should make the souffle that hermione can gobble because ron should chew the croissant that he may chew	james should make the souffle that hermione should gobble because he can chew the croissant that ron may chew
because lupin can make a chocolate that mcgonagall must make since dobby must run sirius may eat the croissants	because lupin can make a chocolate that mcgonagall must make since sirius must run dobby may eat the croissants
since neville can arrange the cakes that harry must arrange neville should sprinkle many eclaires which hagrid must create	since neville can arrange the cakes that harry should sprinkle neville must arrange many eclaires which hagrid must create
sirius may laugh because the witch should assemble a doughnut which hermione must gobble since a witch may run	sirius may laugh because hermione should assemble the doughnut which a witch may gobble since hermione must run
because harry should gobble the doughnut that voldemort must gobble james can hide the strudels which dobby must gobble	because harry should gobble the doughnut that voldemort can gobble james must hide the strudels which dobby must gobble
since ron should hide a cookie that lupin may gobble harry may arrange the eclaires which she must arrange	since ron should hide a cookie that lupin may gobble she may arrange the eclaires which harry must arrange
since fred must make many cakes which lupin must gobble snape should sprinkle the strudel that ginny should sprinkle	since fred must make many cakes which lupin must gobble ginny should sprinkle the strudel that snape should sprinkle
a professor should not hide the chocolates that a student should arrange because a professor should prepare a souffle	a professor should not hide the chocolates that a professor should arrange because a student should prepare a souffle
fred may chew the pancakes that hermione must sprinkle since vernon should hide a doughnut that she must gobble	fred may chew the pancakes that hermione should sprinkle since vernon must hide a doughnut that she should gobble
fred can create the doughnuts since she should jump since voldemort may sprinkle the baklava that draco should chew	fred can create the doughnuts since she should sprinkle many baklava since hermione should chew the chocolate that voldemort should chew
because lily can create the croissant that mcgonagall may gobble george must gobble the cookie which ron must sprinkle	because lily can create the croissant that mcgonagall may gobble george must gobble the cookie that ron must sprinkle
since dobby can gobble the pancakes since snape should hide a croissant that she may make petunia must walk	since dobby can gobble the pancakes since snape should hide a croissant that petunia may chew she must walk
because she can gobble the croissants the witch must not chew a souffle since george should assemble the strudel	because she can gobble the croissants a witch must not chew the souffle since george should assemble the strudel
since draco may gobble the strudel that draco may make because sirius must jump james may create the cookie	since draco may gobble the strudel that sirius may make because draco must jump james may create the cookie
she should hide many cookies that petunia should prepare because fred must eat the souffles that voldemort can gobble	she should hide many cookies that petunia should prepare because fred must eat the souffles that voldemort should gobble
since the professor must prepare a cake petunia can not eat the cakes since hagrid can chew a baklava	since the professor must prepare the cake petunia can not eat a pancakes since hagrid can chew a croissant
since harry should hide the eclaires that he should hide ron should arrange a cookie that ginny must gobble	since harry should hide the eclaires that he should hide he should arrange a cookie that james must gobble
because ron can create the croissant which james can sprinkle sirius should sprinkle the doughnuts which dobby may chew	because ron can create the croissant which sirius can sprinkle james should sprinkle the cakes which dobby may chew
he should assemble a baklava which snape can chew since neville can sprinkle the cookies which neville should arrange	he should assemble a baklava which snape can chew since neville should sprinkle the cookies which neville can arrange
since voldemort must assemble the strudels which james must make lily should make the cookie that he may sprinkle	since voldemort must assemble the strudels which james should make lily must make the cookie that he may sprinkle
because mcgonagall should laugh since george must assemble the cookie since voldemort should laugh james should gobble a eclaire	because mcgonagall should laugh since fred must assemble the cookie since should should walk dobby must gobble a eclaire
since the witch should create the cake because ginny should chew many baklava harry can not prepare the souffles	since the witch should create the souffles because ginny should chew many pancakes harry can not prepare the souffles
because fred may hide the eclaires that albus should gobble ron may laugh since draco must create the eclaire	because fred may hide the eclaires that albus should gobble since ron may laugh draco must create the eclaire
the witch must not sprinkle a cake that he can make because james should laugh since harry may giggle	the witch must not sprinkle a cake that he should make since james can giggle because harry may laugh
lily must prepare the souffle since neville must run because dobby should hide the baklava which albus must arrange	lily must prepare the souffle since neville must run since dobby should hide the baklava which albus must arrange
because petunia must prepare many eclaires that fred can create ron must walk because george must assemble the eclaires	because petunia must prepare many eclaires that ron can create george must walk because fred must assemble the eclaires
since she can assemble the baklava which neville may create petunia should assemble the souffle because snape may smile	since she can assemble the baklava which neville may create petunia should assemble the strudel because snape may smile
because fred must eat the souffles which hagrid can eat mcgonagall may assemble the cookies that mcgonagall should eat	because fred must eat the souffles which mcgonagall can eat hagrid may assemble the cookies that mcgonagall should eat
because the witch can wiggle because petunia may hide a cake james must not swim because james should wiggle	because the witch can wiggle petunia may not hide a doughnut because james must laugh because hermione should wiggle
since harry must eat a souffle fred must chew the pancake that he must sprinkle because petunia should hiccup	since harry must eat a souffle fred must chew the pancake that he must sprinkle because petunia should wiggle
since he must party the professor must not make the croissants that snape should eat because vernon should laugh	since he must party the professor must not make the croissants that vernon should eat because snape should party
because fred must make a eclaire that dobby must prepare draco should arrange the eclaires which fred may prepare	because fred must make a eclaire that dobby must prepare fred should prepare the eclaires which fred may arrange
voldemort must chew a strudel that sirius must eat since vernon should prepare the strudel which vernon should sprinkle	voldemort must chew a strudel that sirius must eat since vernon should prepare the strudel that vernon should sprinkle
because lily should gobble many strudels because hermione may laugh vernon must sprinkle a cookie since fred must wiggle	because lily should gobble many strudels which james may laugh george must sprinkle a cookie since voldemort must wiggle
lupin should create a croissant that lily must arrange since he can sprinkle the eclaire which dobby should prepare	lupin should create a croissant that lily must arrange since dobby can sprinkle the eclaire which he should prepare
because lily can run harry can sprinkle the souffle that neville can hide since lupin can eat the doughnuts	because lily can run neville can sprinkle a baklava that lupin can hide since james can eat the doughnuts
sirius must sprinkle the souffle which lupin may make because hermione can prepare the eclaires that petunia can sprinkle	sirius must make the souffle which lupin may sprinkle because hermione can prepare the eclaires that petunia can sprinkle
since dobby should laugh the student must not make the doughnuts which petunia can make because she can walk	since dobby should laugh the student must not make the doughnuts which she can make because petunia must walk
neville should not sprinkle the cookies which hagrid may prepare because he can run since a professor must smile	neville should not sprinkle the cookies which he may prepare because hagrid can smile because a professor must run
since fred must assemble a eclaire that she can prepare albus must hide a souffle that fred must arrange	since fred must assemble a eclaire that she can prepare fred must hide a souffle that albus must arrange
lupin must hide a cake that she must gobble because ginny should create a pancake since voldemort may giggle	lupin must hide a cake that she must gobble since ginny should create a pancake because voldemort may giggle
since albus must walk draco may not eat the souffles which hagrid can chew because the professor can laugh	since albus must walk george may not eat the souffles which lily can hide since the student can laugh
because ron can chew a cake since dobby should eat the pancakes a witch should not eat the cookies	since ron can chew a cake since dobby should eat the pancakes a witch should not eat the cookies
james should gobble a doughnut that hagrid should sprinkle since petunia must chew a cake which he should eat	james should gobble a doughnut that hagrid should sprinkle since petunia should chew a cake which he can eat
since voldemort should arrange the croissant that harry must chew sirius may arrange the pancakes which hermione may prepare	since voldemort should arrange the croissant which sirius must chew harry may arrange the pancakes that hermione may prepare
a professor may not sprinkle the strudels because hermione may arrange a croissant since vernon should chew many eclaires	a professor may not sprinkle the strudels because george may arrange a croissant because james should chew many eclaires
dobby can make a croissant which ron should eat because lily must make the baklava which petunia can assemble	dobby can make a croissant which lily should eat because ron must make the baklava which petunia can assemble
harry may not hide the chocolate since a professor may eat a croissant because vernon should assemble many strudels	harry may not hide the chocolate since a professor may party because vernon should assemble a strudels
fred may make the eclaires which ron should prepare because ginny must assemble the doughnuts that fred may prepare	fred may make the eclaires which fred should prepare because ginny must assemble the doughnuts that ron may prepare
since george may eat the eclaires that draco can create harry must arrange the strudels which he may sprinkle	since george may eat the eclaires that draco can create harry may arrange the strudels which he must sprinkle
since sirius should eat the cookies that dobby must sprinkle hermione must party since mcgonagall may create the souffle	since sirius should eat the cookies that dobby must jump hermione must hide the cookie that mcgonagall may create
because lily can gobble the souffle that snape must prepare he can hide a cookie that mcgonagall must chew	because lily can gobble the souffle that snape can prepare he must hide a cookie that mcgonagall must chew
because voldemort should create the cakes that hermione must make voldemort can create the baklava that draco should sprinkle	because voldemort should create the cakes that hermione must make voldemort should create the baklava that draco can sprinkle
since he may hide the croissants which she must assemble harry may make the souffles since hermione can party	since he may hide the croissants which she must assemble albus can make the souffles since hermione may giggle
since ginny should chew the chocolate lily must assemble the cookie that hagrid may create since hagrid should walk	since ginny should chew the chocolate lily must assemble the hagrid that hagrid should create since hagrid may walk
because lily must hide a croissant which snape can gobble voldemort may sprinkle the strudels that albus should make	because lily must hide a croissant which albus can sprinkle neville may gobble the strudels that petunia should make
because albus can hide the eclaire she may prepare a eclaire that she may prepare because he must laugh	because albus can hide the eclaire she may prepare a strudel that she may prepare because he must laugh
snape may eat the cake that vernon can arrange because petunia should assemble the cake which mcgonagall can make	snape may eat the cake that vernon should arrange because petunia can assemble the cake which mcgonagall can make
snape should make a pancake that hagrid may gobble since she must eat a souffle that voldemort should prepare	snape should make a pancake that hagrid may gobble since voldemort must eat a souffle that she should prepare
the professor must not assemble the pancakes since ron must chew the souffle since draco can prepare a chocolate	the professor must not assemble the pancakes since ron must chew the chocolate since draco can prepare a souffle
since fred can chew the souffles since hagrid can run george may hide a doughnut that george should create	since fred can chew the souffles since george can run hagrid may hide a doughnut that george should create
fred must arrange the pancake that sirius can eat because petunia may make the eclaire that hagrid can sprinkle	fred must arrange the pancake that petunia can eat because sirius may make the eclaire that hagrid can sprinkle
since harry may wiggle the witch must not swim since snape can create a baklava which petunia must make	since harry may wiggle the witch can not swim since snape must create a croissant which petunia must make
because draco must make a strudel since dobby must prepare a croissant that fred can make neville must run	because draco must make a strudel since dobby must prepare a croissant that neville can make fred must run
since snape may gobble a cake because ron must wiggle vernon should laugh since voldemort can assemble a cookie	since snape may gobble a cake ron must laugh since ron should party because petunia can assemble a cookie
albus can sprinkle the baklava since petunia must walk since ginny may hide the strudels which he should sprinkle	albus can sprinkle the baklava since petunia must walk since he may hide the strudels which ginny should sprinkle
sirius should arrange the strudels which vernon can hide since james should gobble the eclaires that draco must chew	sirius should arrange the strudels which vernon can hide since draco should gobble the eclaires that james must chew
the student should not chew the cookie that a professor should make since a witch must prepare the chocolate	the student should not chew a cookie that the professor should make since a witch must prepare the chocolate
since sirius should assemble the pancakes albus must giggle because hagrid can eat the doughnuts that dobby should assemble	since sirius should assemble the pancakes hagrid must giggle because albus can eat the doughnuts that dobby should assemble
since harry may hide the eclaire because a student must jump albus should not hiccup since draco can laugh	since harry may hide the eclaire because a student must chew albus should not hiccup since draco can smile
mcgonagall must eat the doughnuts since he should create many croissants that ginny can hide because she must laugh	mcgonagall must eat the doughnuts since he should create many eclaires that ginny can hide since she must laugh
because ginny should make a chocolate that hagrid can chew neville can arrange a cake that sirius must assemble	because ginny should make a chocolate that neville can chew hagrid can arrange a cake that sirius must assemble
lily must prepare a eclaire that she must prepare since voldemort must create a cookie which lupin should make	lily must prepare a eclaire that she must prepare since fred must create a cookie which a wizard should prepare
because fred can gobble the strudels which ginny must prepare harry may not chew the pancakes that hagrid must chew	because fred can gobble the strudels which harry must prepare ginny may not chew the pancakes that hagrid must chew
because she must assemble the eclaires because the student can hiccup neville must hide the baklava that mcgonagall can arrange	because she must assemble the eclaires because neville can hide the baklava because hagrid must hide the baklava that neville can hide
voldemort must not gobble the souffles that sirius must gobble since he may eat many strudels that james must create	voldemort must not gobble the souffles that sirius must gobble since he may eat many eclaires that james must gobble
petunia should make the croissant which the wizard should sprinkle since vernon should gobble the doughnuts which ginny must make	petunia should make the croissant which the wizard should sprinkle since petunia should gobble the doughnuts which lupin must make
since fred can create the cookies that lupin should hide voldemort can not hide the eclaire which petunia can gobble	since fred can create the cookies that lupin should hide petunia can not hide the eclaire which she can gobble
dobby must not arrange many chocolates which lupin should gobble because petunia can hide the chocolates which petunia must hide	dobby must not arrange many chocolates which petunia should gobble because snape can hide the chocolates which petunia must hide
since lily should gobble the doughnuts which draco must arrange lupin may not eat the baklava that he can hide	since lily should gobble the doughnuts which lupin must arrange draco may not eat the baklava that he can hide
james must not gobble a eclaire which george should assemble since george should create the souffles because draco can hiccup	james must not gobble a eclaire which george should assemble since george should prepare the cakes since draco can walk
she can arrange the doughnuts that mcgonagall can arrange because a witch may hide many croissants which vernon should prepare	she can arrange the doughnuts that mcgonagall can hide because a witch may arrange many croissants which vernon should prepare
since the witch must make the pancake which a wizard may hide because a student should laugh ron can party	since the witch must make the pancake which a wizard may hide because ron should party a student should laugh
petunia must not laugh because he can prepare the croissants that the student should arrange because the professor must jump	petunia must not laugh because he can prepare the doughnuts that the professor should sprinkle because the student must swim
fred can not hide the eclaire that mcgonagall should make because she should create the croissant which voldemort must make	fred can not hide the eclaire that she should make because mcgonagall should create the croissant which voldemort should make
because the witch must hiccup because hagrid must hide the croissant vernon should sprinkle a chocolate that she may arrange	because the witch must hiccup because hagrid must hide the croissant that vernon may sprinkle she should arrange a baklava
lily must assemble the doughnuts that harry should gobble since sirius must prepare the eclaires which a wizard may gobble	lily must assemble the doughnuts that sirius should gobble since harry must prepare the eclaires which a wizard may gobble
since fred can arrange the eclaires that ginny can create draco can not arrange a cake that petunia must prepare	since fred can arrange the eclaires that petunia can create draco can not arrange a cake that petunia must prepare
ginny should not make a baklava which dobby must gobble because vernon should party because neville may prepare the pancake	ginny should not make a baklava which dobby must gobble because sirius should party because lily may prepare the croissants
petunia must eat a baklava that voldemort should assemble since a student may prepare the croissant that ginny should sprinkle	petunia must eat a baklava that voldemort should assemble since a witch may prepare the croissant that neville should sprinkle
because ginny can hide the cookie since albus can laugh dobby can not create the chocolates that ginny should eat	because ginny can hide the cookie since dobby can laugh albus can not create the chocolates that dobby should eat
albus must not chew the doughnuts that fred should sprinkle because vernon may eat the souffle which fred must create	albus must not chew the doughnuts that fred should sprinkle because fred may eat the souffle which vernon must create
james must not sprinkle the strudels that vernon can sprinkle since voldemort may eat many chocolates that he can arrange	james must not sprinkle the strudels that vernon can sprinkle since voldemort may eat many chocolates that george can arrange
since a witch can gobble the strudels because a professor may assemble a cake albus may not eat the cake	since a witch can gobble the strudels because a professor may assemble the cake albus may not eat a cake
since hagrid must make the souffles that ron must gobble petunia must assemble the doughnut that the professor should chew	since hagrid must make the souffles that ron must gobble petunia must assemble the doughnut that the should chew
since lupin may hide the cookie since the student may jump george can hiccup since neville must chew the chocolates	since lupin may hide the cookie since the student may hiccup george can chew the chocolates since neville must chew the doughnuts
a witch may arrange the souffle which draco can sprinkle since neville must run since voldemort can sprinkle the pancake	a witch may arrange the souffle which neville can assemble since draco must hiccup since voldemort can sprinkle the pancake
since ron must chew the souffles that hagrid should prepare voldemort should not make the cookie which hermione must create	since ron must chew the souffles that voldemort should prepare hagrid should not make the cookie which hermione must create
because george should hide the cake which harry must sprinkle neville may not arrange the doughnuts that she can gobble	because george should hide the cake which harry must sprinkle neville may not arrange the doughnuts that mcgonagall can gobble
he may not create the cakes because draco can eat many baklava that hagrid must prepare since dobby must run	he may not create the cakes since george can prepare many baklava that draco must eat because hagrid must run
because dobby should gobble the chocolate because draco must laugh he may create the souffles since the professor must party	because dobby should gobble the chocolate because he must party draco may laugh the the professor must create the cakes
hagrid may not chew the baklava since harry can sprinkle a strudel which james must eat since hermione can smile	hagrid may not chew the baklava which harry can sprinkle since a witch must eat james can smile
dobby should sprinkle the cakes because harry must assemble the doughnut since sirius must run because the student may wiggle	dobby should sprinkle the cakes because sirius must assemble the doughnut because harry may run because the student must smile
since james can arrange the doughnuts which fred can create because lupin must jump she must not arrange the pancake	since james can arrange the doughnuts which fred can create she must not jump because lupin must arrange the pancake
snape must not arrange the eclaire which petunia must make since lily should sprinkle the souffles that lily should arrange	snape must not arrange the eclaire which petunia must sprinkle since lily should make the souffles that lily should arrange
because snape must prepare the souffles james must sprinkle the chocolate that a wizard should create because neville should swim	because snape must prepare the souffles james must sprinkle the chocolate that hagrid should create because a should swim
because a professor should make the croissants that james should arrange vernon may make the souffle which george must arrange	because a professor should make the croissants that james should arrange george may make the souffle which vernon must arrange
since james can make the cake that the witch should hide she can assemble a chocolate which she should prepare	since james can make the cake that the witch should hide she should assemble a chocolate which she can prepare
because sirius should gobble the cookie that sirius can prepare the student must sprinkle the strudels which hermione must hide	because sirius should gobble the cookie that sirius can prepare the must sprinkle the cookies which sirius must hide
lupin must not hide the souffles that dobby should create since lily must make the strudels that sirius may prepare	lupin must not hide the souffles that dobby should create since sirius must make the strudels that lily may prepare
since lily can prepare the souffles that lily can assemble james must eat a eclaire which the student must arrange	since lily can prepare the souffles that james can assemble lily must eat a eclaire which the student must arrange
since hagrid must sprinkle the croissants which mcgonagall must create vernon should wiggle since a professor must chew the cake	since hagrid must sprinkle the croissants which mcgonagall must create vernon should wiggle since a professor must chew the strudels
because ron should assemble the eclaires that he may make lily should not sprinkle a doughnut since albus must giggle	because ron should assemble the eclaires that he may make lily should not sprinkle a doughnut since lily must giggle
since the student should assemble the eclaires that lily may eat albus should prepare the doughnuts which draco can eat	since the student should assemble the eclaires that albus may eat lily should prepare the doughnuts which draco can eat
because voldemort should wiggle neville can make the strudel since vernon should chew the baklava that a professor can hide	because voldemort should wiggle draco can make the strudel since dobby should chew the baklava that the professor can hide
because a student should assemble a baklava he must not create the cookies since the witch must make the pancake	because a student should assemble many baklava he must not create the pancake since the witch must make the croissant
because vernon should make the eclaire that lupin must gobble because dobby may arrange the croissants james should not swim	because vernon should make the eclaire that lupin must gobble dobby may not arrange the croissants because james should swim
since albus should eat the pancakes which lily should hide he can not create a cookie since voldemort can hiccup	since albus should eat the pancakes which lily should hide he can not prepare a cookie since voldemort can walk
since lupin can smile because george may sprinkle the pancake because lily can create a croissant dobby may not walk	since lupin can smile because george may sprinkle the pancake lily lily can create a eclaire george may not walk
lily must prepare the chocolates that lily may create since fred may prepare a cookie which a witch may gobble	lily must prepare the chocolates that fred may create since lily may prepare a cookie which a witch may gobble
since ron may assemble a baklava which vernon may chew james can not run since fred should gobble the strudels	since ron may assemble a baklava which ron may chew james can not run since fred should chew the strudels
because albus may chew the croissants which he must chew because ron should make a cake james should not walk	because albus may chew the croissants which ron must chew he should not chew a cake because james should walk
since ginny may party hagrid must not assemble a pancake because she may prepare the souffle that she must eat	since ginny may party she may not assemble a pancake because she must prepare the souffle that she must eat
because voldemort must prepare a cookie which a wizard must sprinkle harry can chew the strudels that hagrid can prepare	because voldemort must prepare a cookie which a wizard must sprinkle harry can sprinkle the strudels that hagrid can prepare
since ron may eat the cakes that james may prepare snape should not eat a souffle that petunia must chew	since ron may eat the cakes that james may eat petunia should not prepare a souffle that snape must chew
harry should hide the croissant that ginny should arrange since snape should arrange a doughnut that a professor may create	harry should hide the croissant that snape should arrange since ginny should arrange a doughnut that a may arrange
since he can swim since he may make a croissant which a professor can gobble ron may assemble the croissants	since he can swim since he may make a croissant which a professor can assemble ron may gobble the croissants
draco can prepare a cake that the wizard must make since she must wiggle because draco should gobble many chocolates	draco can prepare a cake that the wizard must make because she must gobble many doughnuts since should gobble the strudels
because a wizard can create the doughnuts a wizard should eat the cakes since a wizard must hide a souffle	because a wizard can create the doughnuts since albus should eat a cake the wizard must hide a cookie which hagrid wizard must
because he should sprinkle the cookie because draco may gobble the chocolate which hagrid must make ron should not hiccup	because he should sprinkle the cookie because ron may gobble the cookie which hagrid not sprinkle the student should not wiggle
since dobby must wiggle ginny may not sprinkle many cookies because sirius must sprinkle the pancakes which lily may assemble	since dobby must wiggle sirius may not sprinkle many cookies which lily must sprinkle because pancakes may assemble the strudels
draco should not chew a pancake that sirius should make since ron should sprinkle a pancake that hagrid should arrange	draco should not chew a pancake that sirius should sprinkle since ron should make a pancake that hagrid should arrange
she should not chew the cookie which fred must hide because vernon can arrange many doughnuts since neville can smile	she should not chew the cookie which vernon must hide because fred can arrange many doughnuts since neville can run
since james can chew the croissants that she should arrange lily should not assemble the doughnuts since snape must run	since james can chew the croissants that snape should arrange she should not assemble the doughnuts since lily must arrange
because james can gobble the cake sirius should prepare the croissants which he should create since a professor may party	since james can prepare the croissants sirius should gobble the cake since she should prepare the cakes since ron may party
since harry should assemble the chocolates she should not make a cookie which sirius should create since hagrid must smile	since harry should assemble the chocolates which she should make sirius should not create a cookie since hagrid must smile
sirius should not sprinkle the pancake since the witch should gobble many cakes because a wizard can create the pancakes	sirius should not sprinkle the cakes since the witch should gobble a pancake since the can create many pancakes
because harry should create the cake which lily must sprinkle lupin should not assemble the doughnuts which albus may sprinkle	because harry should create the cake which lily must sprinkle albus should not sprinkle the doughnuts which lupin may assemble
hagrid should not create the eclaire since ron must assemble the cakes that neville can gobble because james may jump	hagrid should not create the eclaire since ron must assemble the cakes that james can gobble because neville may jump
since james should hide the baklava which sirius may make she may gobble the croissant which a professor can make	since james should hide the baklava which she may make sirius may gobble the croissant which a professor can make
because draco should arrange the eclaires lupin can walk since the professor can prepare the croissant that lily may hide	because draco should arrange the eclaires lupin can create the eclaire since lily may hide the baklava that lily can hide
because lupin can hide the eclaires that petunia should prepare she must hiccup because a professor should gobble a strudel	because lupin can hide the eclaires that she must prepare petunia should sprinkle a strudel because voldemort should gobble a strudel
because she must chew the baklava that sirius can create lupin should prepare the baklava that a professor should make	because she must chew the baklava that she can prepare sirius should create the baklava that a professor should make
voldemort must gobble the pancakes that voldemort can chew because harry may sprinkle many strudels which a professor can hide	voldemort must gobble the pancakes which harry can sprinkle because voldemort may chew many strudels that a professor can hide
since mcgonagall should chew a eclaire which fred should arrange because james may create a doughnut george should not giggle	since mcgonagall should chew a eclaire which fred should arrange because hermione may create a doughnut george should not giggle
mcgonagall can not arrange a baklava that draco must arrange because hagrid can chew the souffles that voldemort should create	mcgonagall can not arrange a baklava that hagrid must arrange because draco can chew the souffles that voldemort should create
since he may prepare the chocolates which mcgonagall can make petunia can not gobble a strudel which fred can chew	since he may prepare the chocolates which petunia can make mcgonagall can not gobble a strudel which petunia can chew
since george can hide the souffles since she must eat many strudels she should not giggle since he can laugh	since george can hide the souffles she must not eat many strudels since she should giggle since he can laugh
voldemort should not create a baklava which sirius can arrange because petunia can hide many baklava that snape must eat	voldemort should not create a baklava which sirius can arrange because petunia can hide many baklava that petunia must hide
hagrid may not arrange the eclaire that voldemort should hide because ron should sprinkle the cake because she may run	hagrid may not arrange the eclaire that voldemort should hide because ron should sprinkle the eclaires because she may hide
because vernon may prepare the doughnuts that fred must hide harry may prepare many doughnuts because the professor should laugh	because vernon may prepare the doughnuts that fred must hide harry may prepare the doughnuts because the professor should laugh
the witch should not hide a strudel since a professor may assemble many baklava because fred must eat a cookie	the witch should not hide a cookie since a professor may assemble a souffle because fred must eat many baklava
since petunia may gobble the eclaires since harry should wiggle petunia must not gobble a souffle that harry should arrange	since petunia may gobble the eclaires since harry should gobble petunia must not make a baklava that harry should gobble
since petunia must arrange many doughnuts which lupin should assemble snape may not make a strudel that she can hide	since petunia must arrange many doughnuts which lupin should assemble she should not make a strudel that snape may hide
a professor may assemble the strudel that petunia should assemble because harry may create the cookies that petunia can eat	a professor may assemble the strudel that petunia should assemble because harry may create the cookies that petunia should eat
lily should jump since sirius should eat a croissant which lupin must prepare because a wizard should create the eclaire	lily should wiggle since sirius should sprinkle a cookie which lupin should create because a wizard must prepare the eclaire
he should not sprinkle many doughnuts since draco should chew many cakes that dobby should create since fred must swim	he should not sprinkle many doughnuts since draco should chew many cakes that fred should create since dobby must swim
since he can hide the chocolates ron must not walk since sirius may make the souffle which fred must chew	since he can hide the chocolates ron may not walk since sirius must make the souffle which ron must chew
because ron should make the cake which she may eat a professor may gobble the cake that petunia can gobble	because ron should make the cake which she may eat a wizard can gobble the cake that she may gobble
dobby must not sprinkle the strudel which albus may arrange because hermione should create a souffle which fred may make	dobby must not sprinkle the strudel which hermione may arrange because albus should create a souffle which hermione may make
since george can arrange a eclaire that voldemort can prepare hermione should create the souffle that the witch should chew	since george can arrange a eclaire that neville can prepare the witch should create the souffles that sirius should chew
hagrid must not make the strudels that petunia must create because neville must create a strudel which harry must arrange	hagrid must not make the strudels that petunia must create because neville must create a eclaire which harry must arrange
since vernon should assemble many doughnuts voldemort can gobble the pancake that hagrid can eat because a witch must swim	since vernon should assemble many doughnuts that voldemort can gobble hagrid can assemble the pancake because a witch must swim
since ginny may eat many croissants which he can prepare since dobby can hide a strudel a wizard should hiccup	since ginny may eat many croissants which he can prepare dobby can hide a strudel since a wizard should hiccup
vernon must not prepare the strudel which the professor must prepare since george should wiggle since the witch must smile	vernon must not prepare the strudel which the wizard must prepare since ginny should hiccup since draco must smile
she may not assemble the souffles that ron should create because mcgonagall must sprinkle a strudel that ron may arrange	she may not assemble the souffles that ron should gobble because she must arrange a strudel that ron may hide
mcgonagall must chew a souffle that the professor must make since snape should gobble a pancake that petunia can eat	mcgonagall must chew a souffle that the professor must gobble since petunia should make a pancake that snape can eat
james may hide a baklava since snape may chew the baklava that she should create since a professor may wiggle	james may hide many baklava since she should chew the baklava since snape may create a chocolate since she may wiggle
since dobby must assemble many croissants that lily must prepare lupin may not gobble a cake which ginny can hide	since dobby must assemble many croissants that lily must gobble lupin can not prepare a cake which ginny may hide
since fred must create the eclaires which lily should arrange hagrid should not make the strudels that dobby should arrange	since fred must create the eclaires which dobby should arrange lily should not make the strudels that hagrid should arrange
because albus should run because sirius must sprinkle the croissant which the student should hide harry may chew the cake	because albus should run because sirius must hide the croissant which sirius should sprinkle the student may chew the cake
hagrid can not prepare the eclaire which petunia can make because he may eat the croissants that ginny must chew	hagrid can not prepare the eclaire which petunia can eat because he may make the croissants that ginny must chew
petunia must not chew many eclaires since fred should party because george can hide the eclaires which dobby should assemble	petunia must not chew many eclaires since george should party because fred should hide the chocolates which petunia can assemble
because lupin must assemble many doughnuts that lily may assemble dobby should not prepare the pancakes that neville should hide	because lupin must assemble many doughnuts that dobby may assemble lily should not prepare the pancakes that neville should hide
because ginny should assemble the doughnuts that a student must make since george should eat a souffle harry must hiccup	because ginny should assemble the doughnuts that a student should make since george must eat a souffle james must hiccup
since voldemort should eat a strudel which mcgonagall may arrange ginny may not eat the baklava that hermione must sprinkle	since voldemort should eat a strudel which mcgonagall may arrange hermione may not eat the baklava that mcgonagall must prepare
because fred must prepare many cookies that vernon must create dobby may not prepare the chocolate that she can arrange	because fred must prepare many cookies that vernon must create dobby may not prepare the chocolate that dobby can arrange
voldemort must hide the chocolate because ginny must gobble the baklava which a wizard may gobble since petunia may laugh	voldemort must hide the chocolate which ginny must gobble since the wizard may gobble a chocolate because petunia may laugh
because hagrid may hide a strudel that the professor can gobble vernon may assemble the strudel that harry should assemble	because hagrid may hide a strudel that the professor can assemble vernon may gobble the cake that harry should assemble
since the student must hiccup since voldemort should eat the doughnut sirius should arrange a eclaire which neville must hide	since the student must hiccup since voldemort should eat a doughnut sirius should arrange the eclaire which voldemort must hide
since james must eat a doughnut petunia should gobble the cakes that george should create since a student can swim	since james must eat petunia should gobble the doughnut that hagrid should create since george can gobble the strudel
because a student may run ginny should gobble the cakes which sirius can sprinkle because albus must hide many cakes	because a student should run because ginny may gobble the cakes which albus should sprinkle james must hide many cakes
since harry should make many pancakes lupin should walk since she can sprinkle the souffles that the student may gobble	since harry should make many pancakes she should jump since lupin may gobble the pancakes that the student can chew
because george may create a doughnut which george may prepare vernon can not prepare many strudels that hermione should create	because george may create a doughnut which george may prepare vernon can not prepare many strudels that george should create
since lily can hide the cookie since albus should make the eclaires that ginny may chew james may not party	since lily can eat the cookie that albus should chew the eclaires james may not smile since albus may jump
because lily must assemble the pancake that the wizard can gobble hermione may sprinkle a baklava that she should create	because lily must assemble the pancake that the wizard can gobble she may sprinkle a baklava that hermione should create
since dobby should create the doughnuts that draco may eat the student should run because dobby must gobble many souffles	since dobby should create the doughnuts that draco may eat because dobby should run because draco must gobble many souffles
since ron must eat the pancake because snape must make the cakes which lily must create lily must not wiggle	since ron must eat the pancake because snape must make the cakes lily must not create the croissants lily must party
draco must not sprinkle the baklava which hermione should eat since she must chew the chocolates that petunia should assemble	draco must not sprinkle the baklava which she should eat since hermione must chew the chocolates that petunia should assemble
since the student may chew the strudels which ginny must hide sirius may giggle because voldemort must hide the souffle	since the student may chew the strudels which petunia must hide neville may laugh because sirius must chew the baklava
james should hide the souffle that george can chew because a wizard should assemble a chocolate that he must hide	james should hide the souffle that george should chew because a wizard can hide a chocolate that he must hide
because draco must eat many souffles that george can make he can not gobble the pancake that lupin must eat	because draco must eat many souffles that he can make george can not gobble the pancake that lupin must eat
since lupin may chew the croissant that sirius must gobble mcgonagall may eat the strudels which the wizard should prepare	since lupin may chew the croissant that sirius may gobble mcgonagall must eat the strudels which the student should prepare
albus must not arrange the strudel which she must hide because neville should create the cake that james should chew	albus must not arrange the strudel which she must hide because james should create the pancakes that neville should chew
since sirius must hide the cakes a professor may not assemble a pancake because the professor can eat a baklava	since sirius must hide the cakes a professor may not assemble a pancake because a professor can eat the baklava
he may not assemble the chocolate which vernon should hide because he can eat the souffle which draco may sprinkle	he may not assemble the chocolate which ron should eat because george can hide the baklava which draco may sprinkle
because george may chew a cake which the professor should arrange mcgonagall may create the chocolate that dobby can make	because george may chew a cake which the professor should arrange mcgonagall may create the chocolate that mcgonagall should make
since harry should gobble the baklava hagrid can not wiggle since ginny must prepare the croissant that neville must create	since harry should gobble the baklava hagrid can not prepare the croissant since neville must create
because vernon should create the baklava that lupin should prepare the witch should eat the croissants that sirius must sprinkle	because vernon should create the baklava that lupin should eat the witch should prepare the croissants that sirius must sprinkle
because petunia should hiccup dobby should not chew a cake that hermione must chew since snape should eat a baklava	because petunia should hiccup dobby should not chew a cake that hermione should chew since snape must eat a baklava
dobby must make the chocolates which george may assemble because the professor must create the souffles that lupin must gobble	dobby must make the chocolates which george may assemble because lupin must create the souffles that the professor must gobble
since lily should gobble the pancake that petunia must eat she should not hide the doughnuts which neville should arrange	since lily should gobble the pancake that petunia must hide she should not eat the doughnuts which neville should arrange
because a wizard should sprinkle the eclaire that hermione must arrange draco can sprinkle a strudel that fred can gobble	because a wizard should sprinkle the eclaire that hermione must arrange fred can sprinkle a strudel that draco can gobble
since neville should walk because she can sprinkle the pancakes the witch must hide a cookie that harry must arrange	since neville should walk because she can sprinkle the pancakes harry must hide the cookie that a witch must arrange
draco should not chew the eclaire that hermione must assemble since harry may gobble a cookie which she must prepare	draco should not chew the eclaire that hermione must assemble since she may gobble a cookie which harry must prepare
since sirius may prepare a chocolate ginny may not hiccup since voldemort must make the baklava that voldemort may eat	since sirius may prepare a chocolate voldemort may not hiccup since voldemort must make the baklava that voldemort may eat
because he can create the doughnuts mcgonagall must not walk because george may arrange many chocolates that snape should hide	because he can create the doughnuts mcgonagall must not walk because george should hide many chocolates that mcgonagall may arrange
since neville can assemble a baklava that george should gobble he should not make the croissants because he must smile	since neville can assemble a baklava that he should gobble george should not make the croissants because he must smile
because voldemort should eat a souffle that hermione may chew fred may not giggle because dobby can hide a strudel	because voldemort should eat a souffle that hermione may chew hermione may not giggle because dobby may hide a strudel
since draco can jump snape may not make the pancakes since james must gobble many strudels which james should make	since draco can jump james may not make the strudels since snape must gobble many pancakes which james should make
since albus may create a eclaire that lily should sprinkle lupin should not assemble many cookies that james must arrange	since albus may create a eclaire that lily should sprinkle james should not assemble many cookies that lupin must arrange
lily can sprinkle a baklava which ron should prepare since ginny should arrange a cake that the professor may sprinkle	lily can sprinkle a baklava which lily should prepare since james should arrange a cake that the wizard may sprinkle
he should not hide a souffle which hagrid may sprinkle because ron can eat the baklava that petunia should sprinkle	he should not hide a souffle which hagrid may sprinkle because petunia should hide the baklava that ron can sprinkle
george must chew a doughnut which draco must create since vernon should hide the baklava that a professor must make	george must chew a doughnut which vernon must create since draco should hide the baklava that a professor must arrange
harry may not chew many eclaires which dobby should make since neville may assemble a cookie which ron must make	harry may not chew many eclaires which neville should make since dobby may assemble a cookie which ron must make
because james must create the pancakes that hermione must gobble draco must not eat the cakes which lily must arrange	because james must create the pancakes that hermione must gobble lily must not eat the cakes which draco must arrange
since hermione should sprinkle a cookie that george can eat james should not eat the chocolates that voldemort must assemble	since hermione should sprinkle a cookie that hermione can eat dobby should not eat the chocolates that james must assemble
since draco should chew the chocolates because mcgonagall may arrange the eclaires which dobby must arrange neville may not jump	since draco should chew the cakes which mcgonagall may arrange the eclaires dobby must not make the pancake
since she may arrange a pancake that lily can eat vernon must chew the eclaire that the professor should make	since she may arrange a pancake that lily can hide vernon must make the chocolates that the professor should arrange
since albus must eat the baklava that hermione may gobble neville must sprinkle a eclaire that the wizard should hide	since albus must eat the baklava that hermione may sprinkle neville must gobble a eclaire that the wizard should hide
because fred can create the chocolates that a professor must sprinkle a wizard should gobble the cookie which he should assemble	because fred can create the chocolates that a professor must sprinkle a should should gobble the cookie
vernon should not make the souffles which fred can eat because the student may assemble many cookies that albus should hide	vernon should not make the souffles which fred can eat because the wizard should assemble many cookies that fred may hide
because james may hide the eclaire hagrid can not run because fred must chew a doughnut which the wizard may assemble	because james may hide the eclaire hagrid can not run because fred must chew the doughnut which a wizard may assemble
since a student should arrange the cake that hagrid may hide draco can arrange many souffles that a professor must sprinkle	since a student should arrange the cake that hagrid may hide since draco can many souffles that a wizard must sprinkle
he must not eat the cookie because hermione must gobble the baklava which hagrid should arrange since harry may party	he must not eat the cookie which neville must gobble since ron should assemble the baklava because hagrid may party
harry should not create the chocolates that ron may chew since a witch must create the souffles which mcgonagall can sprinkle	harry should not create the chocolates that a wizard may chew since hermione can create the cake that james must sprinkle
since snape must chew a doughnut the professor should run since petunia should create a souffle that the student should arrange	since snape must chew a doughnut the should should create a cookie the student should arrange a doughnut that petunia should arrange
lily can not prepare the doughnuts that ron should assemble since draco can create the chocolates since a student must laugh	lily can not prepare the doughnuts that draco should assemble since ron can create the chocolates since draco must hide a chocolate
sirius may not eat the strudels because dobby can laugh because he should make the pancake that a wizard should hide	sirius may not eat the strudels because dobby can laugh because he should make the chocolates that a wizard should hide
since mcgonagall can wiggle voldemort can not make the pancake since albus should make a chocolate which the professor can gobble	since mcgonagall can wiggle voldemort can not make a pancake since albus should make the chocolate which the professor can gobble
vernon should not sprinkle the baklava which albus can make since ginny should prepare a doughnut that the wizard must gobble	vernon should not sprinkle the baklava which albus can make since ginny should prepare a doughnut that vernon must sprinkle
albus may not prepare many croissants that fred should prepare because the professor may gobble the cakes which james should make	albus may not prepare many croissants that fred may prepare because the should should the the chocolates which the professor may
since vernon must walk since neville can eat a strudel which a student must make snape should not arrange many doughnuts	since vernon must walk since neville must eat a strudel which a student can make snape should not arrange many doughnuts
since vernon must prepare a souffle which lupin should eat lupin can not prepare many doughnuts that the professor may make	since vernon must prepare a souffle which lupin should eat lupin should not prepare many doughnuts that lupin may make
she should not gobble a chocolate which a witch should create since ginny should make the pancake that albus must make	she should not gobble a chocolate which a witch should create since ginny should make the chocolate that albus must make
hermione may not create the eclaires which he should eat since the professor can make a souffle that sirius can make	hermione may not create the eclaires which he can eat since the professor should make a souffle that sirius can make
sirius should create the eclaires because sirius can assemble the baklava since james must prepare a cookie that she can make	sirius should create the eclaires because james can assemble the baklava because sirius must prepare a cookie that she can make
the wizard must assemble the cookies which the student can create because sirius can prepare the baklava that george should make	the wizard must assemble the cookies which the student can prepare because sirius can create the baklava that george should make
because ginny must prepare the cake which a professor can hide voldemort may not sprinkle the baklava that james must arrange	because ginny must prepare the cake which a witch can hide voldemort may not sprinkle the baklava that ron must arrange
she must not party since vernon must prepare the croissants that vernon can chew because a wizard may arrange a pancake	she must not party because vernon must prepare the croissants that vernon can chew since vernon may arrange a pancake
because draco should sprinkle the chocolates george must not wiggle because draco may party since a wizard must eat the doughnut	because draco should sprinkle the chocolates george must not wiggle because draco may eat a doughnut since vernon must eat the cookies
sirius should not sprinkle a souffle which neville can arrange since the wizard must eat the strudels which lily must create	sirius should not sprinkle a souffle which neville can arrange since the must eat the strudels which the wizard must create
he should not hide the eclaires which sirius should hide since petunia may prepare the doughnuts that the professor can gobble	he should not hide the eclaires which sirius should hide since petunia may prepare the doughnuts that the student can gobble
because lily must chew a cake because lupin may create the cookie that a professor may create petunia may not swim	because lily must chew a cake because lupin may create the cookie that a wizard may create snape may not swim
hermione must not eat a baklava which voldemort can prepare because the professor can arrange many pancakes which he must make	hermione must not eat a baklava which voldemort can prepare because he can arrange the pancakes which lily must make
because a student may arrange the chocolates because he may wiggle hagrid may not assemble a croissant since petunia may laugh	because a student may arrange the chocolates because he may gobble a croissant hagrid may not laugh since petunia may may laugh
since neville should create the strudel which a student should sprinkle vernon may not chew a souffle since mcgonagall may party	since neville should create the strudel which a student should chew a may not sprinkle a strudel since mcgonagall should party
sirius must gobble the cakes that the student should hide because sirius should make a doughnut which the professor must sprinkle	sirius must gobble the cakes that the student should hide because sirius should make a doughnut which the student must sprinkle
since the professor can gobble the eclaires since lily must make a pancake that voldemort should hide she must not hiccup	since the professor can gobble the eclaires since lily must make a voldemort that voldemort should hide she must not hiccup
since draco may sprinkle the baklava since a witch should assemble the eclaire which petunia must arrange dobby should not laugh	since draco may sprinkle the baklava since a witch should assemble the eclaire dobby must not arrange the eclaires
since lupin may assemble the baklava that snape must make albus should not gobble a cookie which a witch may make	since lupin may assemble the baklava that snape must gobble albus should not make a cookie that a witch may make
since hagrid may eat the doughnuts hagrid must make the eclaire which harry must eat because neville must chew the doughnuts	since hagrid may eat the doughnuts hagrid must make the eclaire which harry must hide because neville must gobble the doughnuts
because albus should chew the souffle that ginny may sprinkle because hagrid should chew the pancakes fred should eat the strudel	because albus should chew the souffle that ginny may sprinkle hagrid should chew the pancakes because fred should eat the strudel
because a professor may create a souffle since he may smile since the witch should laugh the student can not hiccup	because a professor may create a souffle since he may smile the student should not hiccup since the student can laugh
vernon may prepare the chocolates that george may hide since a professor must make the chocolate which a professor can eat	vernon may prepare the chocolates that george may make since dobby must hide the chocolate which a professor can eat
a witch can eat a cake that the professor should chew since vernon must gobble the cake which he can make	a witch can eat a cake that the professor should gobble since vernon must chew the cake which he can make
because george must chew the chocolates since he should prepare the doughnut that fred may hide lily must eat the souffle	because george must chew the chocolates since he should prepare the doughnut that he may hide the wizard must prepare the cake
because neville must giggle mcgonagall must not hide the pancakes since a student can eat the pancake that lily must hide	because neville must giggle mcgonagall must not hide the pancakes since a student must hide the pancake that lily can eat
since petunia must create the souffle snape must arrange a eclaire because james must chew the baklava which vernon must sprinkle	since petunia must create the souffle snape must laugh because vernon must chew the baklava which the witch must sprinkle
since a professor should hide the cakes which ginny must chew a student must smile since fred must hide the pancake	since a professor should hide the cakes which ginny must chew a student must hide since fred must hide the cakes
because he can sprinkle the souffle he can prepare the souffles because sirius can chew a eclaire that james must prepare	because he can sprinkle the souffle he can prepare the eclaires because sirius can chew a strudel that draco must prepare
since the witch may gobble the doughnuts that hagrid may hide sirius may hide the eclaires that the professor should create	since the witch may sprinkle the doughnuts that hagrid may hide sirius may create the eclaires that the professor should hide
ron should eat the croissants because harry can chew a doughnut because dobby should make the cake which draco can assemble	ron should eat the croissants because sirius should chew a cake because lily can make the doughnut which sirius can assemble
because mcgonagall must sprinkle a strudel draco can chew a eclaire because hermione should gobble a cake which snape should chew	because mcgonagall must sprinkle a strudel draco can chew a eclaire because snape should gobble a cake which hermione should chew
since fred should eat a eclaire that sirius should chew because james should prepare many cakes dobby must assemble a doughnut	since fred should eat a eclaire that sirius should chew because dobby should prepare many cakes james must assemble a doughnut
since hermione should walk neville should not create the croissants which snape may sprinkle because a witch must prepare a eclaire	since hermione should walk hermione should not create the strudels which neville may sprinkle because a witch must create a chocolate
she can sprinkle the souffles that george must eat because a professor must prepare the doughnut which the wizard can prepare	she can sprinkle the souffles that george must eat because a professor must prepare the doughnut which vernon can prepare
hermione may create the cake which a professor can prepare because harry should eat the cookies which the student should chew	hermione may create the cake which a professor can eat because harry should prepare the strudels which the student should chew
since ginny should hide the souffles that sirius may arrange a wizard should not jump since harry may hide the strudels	since ginny should hide the souffles that harry may arrange hagrid should not hide a doughnut since sirius may chew the cakes
since james can assemble the pancakes ron can prepare the eclaires that dobby must eat because voldemort must make a chocolate	since james can assemble the pancakes ron can eat the eclaires that dobby must prepare because voldemort must make a chocolate
mcgonagall should gobble the doughnuts that a professor must eat since he must hide the cookies which a wizard can prepare	mcgonagall should gobble the doughnuts which a professor must eat since he must hide the cookies that a wizard can prepare
petunia should not prepare many chocolates which petunia should eat since the professor must chew the cookies which vernon must hide	petunia should not prepare many chocolates which petunia should eat since the must chew the cookies which the wizard must hide
mcgonagall can not hide the eclaires that she should hide because neville must assemble the croissants that the student may sprinkle	mcgonagall can not hide the eclaires that she should hide because neville may assemble the croissants that the student must sprinkle
since lily may create the pancakes that lupin should gobble since a witch should party dobby may not make the cookies	since lily may create the pancakes that lupin should gobble since dobby should party a witch may not make the cookies
because she should hide the croissants lily can arrange a baklava because ginny must create a pancake which he can create	because she should hide the croissants ginny can create a pancake because he must arrange a baklava which lily can create
since lily should arrange the baklava ginny can run because dobby can gobble a pancake because neville must chew many baklava	since lily should arrange the baklava ginny can run because dobby can gobble a baklava because neville must chew many croissants
ron should make a doughnut since lupin may prepare the croissants which vernon can gobble since hagrid must hide a pancake	ron should make a doughnut which lupin may prepare since the wizard can chew a pancake since george must hide
because mcgonagall may gobble the pancakes a student may not swim since draco must create a eclaire that james can hide	because mcgonagall may gobble the pancakes a student must not swim since draco may create a eclaire that james can hide
since james must prepare a baklava that vernon can create a professor must eat the chocolate which a student must prepare	since james must prepare a baklava that vernon can create a professor must eat a chocolate which vernon must prepare
because a professor must hide the strudels which dobby may prepare james should not assemble the strudels that she should hide	because a professor must hide the strudels which dobby may prepare sirius should not assemble the strudels that she should hide
because he can gobble a doughnut because she should make the pancake that snape should eat george may sprinkle the strudels	because he can gobble a doughnut because she should make the pancake that hermione should eat she may chew the strudels
because dobby can eat the chocolate that dobby must chew lily can not wiggle since the wizard can hide the baklava	because dobby can eat the chocolate that dobby must chew lily can not hiccup since the wizard can hide the baklava
because voldemort should arrange a baklava petunia can chew a cake because hermione must prepare a cake which dobby can prepare	because voldemort should arrange a baklava dobby can chew a cake because hermione must prepare a cake which dobby can prepare
because the witch must assemble a strudel that vernon can make he may not prepare the pancake which fred should eat	because the witch must assemble a strudel that george may make lupin can not prepare the doughnuts which he should eat
because lily can make the chocolate voldemort must sprinkle the cookies that fred should hide because lily may hide the souffles	because lily can make the chocolate voldemort must sprinkle the cookies that fred should hide lily may assemble the cakes
since sirius may eat a baklava neville may prepare the pancakes because snape can eat many cookies that snape must hide	since sirius may eat a baklava neville can prepare the pancakes because snape may eat many cookies that snape must hide
james can not hide many chocolates that albus can make since hermione must arrange the chocolates that a witch may arrange	james can not hide many chocolates that hermione can make since albus must chew the chocolates that a witch may arrange
since hermione should prepare a souffle which a wizard should prepare because snape should assemble many cookies dobby can not smile	since hermione should prepare a souffle which a wizard should prepare because should not assemble many cookies because dobby should smile
because snape may chew a cake because a professor may create a pancake that hermione should make sirius should not party	because snape may chew a cake that a student may create because sirius should make the pancake she should not party
because sirius may party mcgonagall must hide the croissants that fred can make because she must swim because harry should jump	because sirius may party mcgonagall can hide the croissants that she must make because fred should party because james must jump
since she must sprinkle the croissant which the wizard should hide george may not make the cookies that harry can eat	since she must sprinkle the croissant which the wizard should hide petunia may not make the cookies that hagrid can hide
since vernon may hide a pancake because she should create a doughnut that albus may prepare lupin must prepare a cookie	since vernon may hide a pancake that she should create because lupin may prepare a doughnut harry must prepare a souffle
because lily should eat a baklava harry should create the souffle that voldemort can assemble because snape should chew a souffle	because lily should eat a baklava harry should create the souffle that neville should assemble because snape can chew a souffle
the professor should not assemble the cookies that hagrid may chew since snape should make a cookie that dobby should hide	the professor should not assemble the cookies that dobby may chew since mcgonagall should make a cookie that sirius should hide
since a student must party harry must hide many cookies that a student may prepare because albus should eat a baklava	since a student must party harry must hide many baklava that a student may eat because albus should prepare many cookies
because petunia should chew the doughnut that ginny must sprinkle fred must not hide a strudel which a professor can eat	because petunia should chew the doughnut that ginny must sprinkle fred must not hide a strudel which a witch can eat
the student should prepare a baklava that vernon must eat because a student must create the cake that he must create	the student should prepare a baklava that a student must eat because vernon must create the cake that must must create
james must not prepare a strudel which she should sprinkle since he should gobble the chocolates that a student may gobble	james must not prepare a strudel which she should gobble since he should sprinkle the chocolates that a student may gobble
because lily should prepare the cookie that the student must eat lily should wiggle because a professor should hide the doughnuts	because lily should prepare the cookie that the professor must eat because should hide a baklava because the should hide the doughnuts
he can not hide a croissant which a witch must eat since neville should gobble the cookies which petunia must make	he can not hide a croissant which a witch must eat since petunia should gobble the cookies which neville must gobble
since dobby can prepare the baklava which james should eat since the professor must assemble the croissants vernon may not walk	since dobby can prepare the baklava since james should eat the croissants which vernon must assemble since vernon may walk
since a witch must create the cake that a professor should prepare george must sprinkle the eclaires which neville should hide	since a witch must create the cake that a professor should sprinkle george should prepare the eclaires which neville must hide
since snape must chew a baklava harry must arrange the doughnuts because george should make the chocolates that petunia must make	since snape must chew a baklava vernon must make the doughnuts that neville should arrange because petunia must make the chocolates
because a professor should assemble a croissant that harry must arrange the wizard can sprinkle a baklava that ginny must create	because a professor should assemble a croissant that ginny must arrange a wizard can sprinkle the baklava that harry must create
since snape may chew a pancake which lupin can arrange since snape should arrange the pancakes lupin can prepare a cake	since snape may chew a pancake which lupin can arrange snape should arrange the pancakes since snape can prepare a cake
fred can not assemble a eclaire which vernon should sprinkle since the professor should hide a pancake which james may chew	fred can not assemble a eclaire which vernon should sprinkle since ron should hide the pancake which a professor may chew
since ginny may create a doughnut that ginny can hide hermione should not eat a strudel which the student should chew	since ginny may hide a doughnut that hermione can create ginny should not eat a strudel which the witch should chew
because hagrid can party because sirius should hide a souffle vernon must not prepare the cake that a witch must make	because hagrid can party because sirius should eat a souffle vernon must not hide the cake that a witch must make
since george can arrange the cake ron can prepare the eclaires that albus must hide because lupin may arrange a cookie	since george can arrange the cake albus can prepare the cookie that ron must hide because lupin may arrange a eclaire
mcgonagall must not gobble the strudels that hermione should create because albus should assemble a cake which the witch may assemble	mcgonagall must not gobble the strudels that hermione should assemble because albus should create a cake which the witch may assemble
since lupin may party a professor should not assemble the pancake that neville must assemble since vernon can assemble the croissants	since lupin may party a professor should not assemble the pancake that sirius must assemble since dobby can assemble the croissants
voldemort may not gobble a cookie that hagrid should create because the professor should create the cookie which ginny must assemble	voldemort may not gobble a cookie that hagrid should create because the professor should create the cookie which hagrid must assemble
the wizard can not make the cakes which sirius must chew since hagrid can chew the strudel that neville must chew	the wizard can not make the cakes which sirius must chew since hagrid can chew the strudel that sirius must chew
since the wizard must sprinkle the souffles that neville should chew voldemort may not make the eclaires because lupin must giggle	since the wizard must sprinkle the souffles that neville should chew voldemort may not make the eclaires that lupin must hide
since vernon may eat the souffles which lily should create draco must not jump because the professor must create many cookies	since vernon may eat the souffles which lily should create draco must not jump because lily must create the cookies
hagrid must not chew the baklava which he must assemble because he may chew the souffle that the professor should make	hagrid must not chew the baklava which he must assemble because he may chew the souffle that the professor should chew
since george should giggle since albus can create many pancakes lily should chew many souffles because she can make a doughnut	since george should run albus can chew many souffles because she should party because albus can chew a cake
because george must prepare the baklava lupin may not run because the professor must make the pancakes that harry should arrange	because george must prepare the baklava because lupin may run the professor must not make the pancakes that harry should arrange
petunia should not create the cookie which she should prepare because the wizard should gobble the croissant which snape must chew	petunia should not create the cookie which she should prepare because the wizard should chew the croissant which snape must chew
because james may make a croissant that dobby should sprinkle dobby must gobble the strudels since albus may make the cookies	because james may make a croissant that dobby should sprinkle albus must gobble the pancakes since dobby may make the eclaires
sirius may not arrange many baklava that a student must assemble since harry should gobble many chocolates that sirius can create	sirius may not arrange many baklava that a student must assemble since sirius should gobble many chocolates that harry can create
a wizard may not create a doughnut that draco must sprinkle since vernon may assemble a cake that george must arrange	a wizard may not create a doughnut that draco must sprinkle since george may assemble a cake that vernon must arrange
because draco can hide the doughnuts that vernon can gobble snape may not chew the doughnut that the wizard should create	because draco can hide the doughnuts that vernon can gobble snape may not chew the doughnut that vernon should create
because albus should assemble a pancake she can make the croissant that the student should chew because a professor should laugh	because albus should assemble a pancake she can make the croissant that the professor should chew because hagrid should laugh
since voldemort must hide the croissants that hermione can hide sirius should not gobble the pancakes that a witch may gobble	since voldemort must hide the croissants that hermione can eat sirius should not chew the pancakes that a witch may gobble
albus must sprinkle a cake because snape must sprinkle a croissant that george should gobble because albus must chew a souffle	albus must sprinkle a cake because snape must sprinkle a croissant that george should gobble because harry must chew a cake
since mcgonagall can create the eclaires which a witch can assemble he must not prepare many cakes that he must assemble	since mcgonagall can create the eclaires which a witch can create he must not assemble many cakes that he must assemble
since the professor may chew many cookies that the witch should hide albus should hide the cakes that he can hide	since the professor may chew many cookies that the should hide the cakes should hide the cakes that he can hide
since lily should swim dobby should not assemble a croissant that ginny should create since the professor should hide the cookies	since lily should swim dobby should not assemble a croissant that ginny should hide since the professor should create the cookies
hagrid may not chew a baklava which the witch must arrange because draco can smile because sirius must chew many cookies	hagrid may not chew a baklava which the witch must arrange because draco must smile because sirius can chew many eclaires
because sirius must make many souffles that hermione can hide george must not make the baklava since a wizard may wiggle	because sirius must make many souffles that hermione can hide george must not make the baklava since vernon may wiggle
she should not make a strudel that she can assemble because the professor may sprinkle the croissant which harry may make	she should not make a strudel that she can assemble because harry may sprinkle the cookie which the professor may make
because ron should chew the strudels that ginny can prepare because hermione must create a souffle george can arrange a cake	because ron should chew the strudels that ginny can prepare hermione must create because george can arrange a cake
hermione should not sprinkle a eclaire that dobby should hide because hermione should eat the pancake which a witch should create	hermione should not sprinkle a eclaire that hermione should hide because dobby should eat the pancake which a witch should create
mcgonagall should prepare the eclaire that lily should sprinkle because the wizard may sprinkle a cookie which a witch should eat	mcgonagall should prepare the eclaire that ginny should sprinkle because the wizard should sprinkle a cookie which a witch may prepare
because the wizard can make a baklava that fred should create since neville must smile a student should gobble the cakes	because the wizard can make a baklava that fred should create since neville must smile fred should chew a chocolate
since the student may prepare the doughnut that vernon must arrange because she can wiggle fred can not prepare a strudel	since the student may prepare the doughnut that vernon must arrange because she can prepare a strudel fred can not make a doughnut
dobby must not prepare the chocolates that harry can arrange since petunia may eat the chocolates that the wizard may chew	dobby must not prepare the chocolates that harry can eat since petunia may arrange the chocolates that dobby may chew
fred must not prepare a pancake that lily must hide because voldemort may eat the chocolates since a witch may jump	fred must not prepare the pancake that voldemort must eat since lily may hide a chocolates since a witch may chew
the wizard must eat the baklava that albus may prepare because lily must chew the chocolate because a professor may giggle	the wizard must eat the baklava that albus may prepare because lily must chew the chocolate because albus may giggle
james must sprinkle the souffles which a professor can create since the witch should create many cookies that ginny can gobble	james must sprinkle the souffles which a professor can create since ginny should create the cookies that a witch can gobble
because hagrid should make many strudels ron should not arrange a eclaire because he can make the croissants that he must assemble	because hagrid should make a strudels ron should not arrange many croissants because he can make the eclaire that he must assemble
since he can make many chocolates george may gobble the strudels which vernon can chew since a student can gobble the cakes	since he can make many chocolates george may gobble the strudels which vernon can chew since draco can gobble the cakes
because petunia should hiccup the witch may not make the doughnuts that a witch can hide since fred must create the cakes	because petunia should hiccup the witch may not make the doughnuts that the witch can hide since fred must create the cakes
because petunia may swim a student must not gobble the strudels which neville can chew because a student may arrange the doughnuts	because petunia may swim neville must not gobble a strudels which the student can arrange because neville may chew the chocolates
george can not eat the cookie because lily must arrange many eclaires since petunia may make a croissant that fred may assemble	george can not eat the cookies because lily must arrange since voldemort may make petunia may assemble that lily may gobble
because ron may hide the chocolate that petunia can assemble albus can not arrange the souffle since lily may hide the souffles	because ron may hide the chocolate that petunia can assemble albus may not hide the souffles since lily can arrange the souffle
because harry may prepare the strudels that sirius must prepare the student may not eat the strudels which a student must make	because harry may prepare the strudels that sirius may prepare the student must not eat the strudels which a student must make
because voldemort must laugh since a witch must arrange a croissant sirius must not chew a eclaire which a student must make	because voldemort must laugh since sirius must arrange a croissant a witch must not chew a eclaire which a student must arrange
since hermione must make many croissants james should not sprinkle a pancake since draco must hide the doughnut that lily must gobble	since hermione must make many croissants james should not sprinkle a doughnut since draco must hide the pancake that lily must gobble
a student can not assemble the doughnuts which fred may create since she can hide the croissants that the professor must make	a student can not assemble the doughnuts which she may create since fred can hide the croissants that the professor must make
because the wizard may hide a croissant which she must gobble george may not eat the cakes which the student should prepare	because the wizard may hide a croissant which george may gobble she must not eat the cakes which the student should prepare
since the student should run george can not arrange a doughnut because he may gobble the chocolates which a wizard must prepare	since the student should run george can not arrange a eclaire because george may gobble the doughnuts which a professor must gobble
since lupin should arrange the eclaires albus may not hide the croissants that ron must make since dobby should hide the baklava	since lupin should arrange the eclaires albus may not hide the croissants that ron should make since dobby must hide the baklava
since hagrid should jump a professor can sprinkle the strudel which a professor may hide because the wizard may chew the baklava	since hagrid should jump a professor can hide the strudel which the wizard may sprinkle because the professor may chew the baklava
since he can create the cakes since harry should eat the pancake lily may not arrange a doughnut which george should hide	since he can create the cookie since lily should eat the croissants vernon may not arrange a cake which mcgonagall should hide
the student must make the cake since a professor may walk because voldemort should prepare the baklava that a witch may sprinkle	the student must make the cake because a professor may create the chocolate because voldemort should sprinkle the baklava that harry may prepare
the witch must not chew the pancake that hermione should assemble since vernon must sprinkle a pancake which the professor should eat	the witch must not chew the pancake that hermione should assemble since vernon must sprinkle the pancake which a professor should eat
because ginny must prepare the cake she must not hide the baklava because draco may eat the chocolate which petunia must chew	because ginny must prepare the cake she may not eat the baklava because petunia must hide the chocolate which draco must chew
albus can not sprinkle the cakes that petunia should assemble since the student must make a cake that a professor may sprinkle	albus can not sprinkle the cakes that petunia should assemble since the student should sprinkle a cake that a student may sprinkle
because harry must walk the professor can gobble a cookie which a wizard should prepare because a student may create the baklava	because harry must walk the wizard can gobble a cookie which a professor should prepare because a student may create the baklava
since the student must wiggle hermione should not create the baklava because the student must make the pancakes which draco must chew	since the student must wiggle draco should not create the pancakes which the student must make because draco must chew the baklava
since ginny may sprinkle the cakes that a professor can gobble dobby should not arrange the chocolates which the witch can eat	since ginny may sprinkle the cakes that dobby can gobble a professor should not arrange the chocolates which dobby can eat
because the student should laugh a witch must not eat the souffle that fred must create since lupin should create the cookies	because the student should laugh a witch must not hide the souffle that fred must create since lupin should eat the cookies
because fred must arrange a souffle since dobby can make the cake a student must eat the eclaires that james must chew	because fred must arrange a souffle since a witch can make the cake dobby must hiccup since the student must chew the eclaires
since petunia must arrange many baklava since george must eat the doughnut since ron should eat a chocolate hermione must not walk	since petunia must arrange the baklava since george must eat a doughnut which draco should eat since must not walk
the professor can not make the pancakes that he may eat since the witch must eat the doughnuts that mcgonagall must prepare	the professor can not make the pancakes that neville may eat since the student must eat the doughnuts that mcgonagall must prepare
because the professor may hide the cookies that a student should gobble fred should not eat the baklava which sirius should assemble	because the professor may hide the cookies that a student should gobble sirius should not eat the baklava which fred should assemble
because ron must chew a chocolate because james can eat a souffle vernon must not prepare the doughnuts that hermione must create	because ron must chew a chocolate because james can eat a souffle hermione must not prepare the doughnuts that vernon must create
sirius can not chew a chocolate that mcgonagall should hide since a student may sprinkle the cakes that a wizard should prepare	sirius can not chew a chocolate that mcgonagall should hide since a student should sprinkle the cakes that a wizard may prepare
since mcgonagall should make the strudel he can not eat the souffle since albus should prepare the cookies which snape should chew	since mcgonagall should make the strudel he can not eat the cookie since snape should gobble the cookies which should should chew
snape must not create the eclaire since hagrid may eat the baklava because he must hide the eclaires that voldemort may gobble	snape must not create the eclaire since hagrid may eat the cookies because he must hide the chocolates that hagrid may gobble
since vernon must assemble a cookie he should not hide a baklava since lily can prepare the croissants which albus should create	since vernon must assemble a baklava since should not hiccup since lily should prepare the chocolate which he can assemble
because a student should arrange the cookie the student must not assemble the cookies that george should chew since fred must swim	because a student should arrange the cookie the student should not assemble the cookies that fred must chew since george should swim
lily must not create the croissants which lupin must create because lily can eat the croissants since hagrid should arrange the cakes	lily must not create the croissants which lupin must create since he can eat the croissants because dobby should arrange
dobby can not assemble a baklava which the witch may hide since a witch must prepare the cakes that he may eat	dobby can not assemble a baklava which the witch may hide since the witch must prepare the cakes that he may eat
since lupin must hide a chocolate sirius may not gobble the baklava since james may arrange the doughnut which albus may gobble	since lupin must hide a baklava james may not gobble the chocolate since sirius may arrange the doughnut which albus may gobble
since he should hide a croissant since george can gobble the strudel which the student must gobble lupin may arrange a souffle	since he should hide a croissant since george can gobble the strudel which the student gobble since hagrid must arrange a souffle
since sirius can arrange a cookie hagrid should not hide many baklava because lily must hide the doughnut that snape must sprinkle	since sirius can arrange a cookie hagrid should not hide because lily must hide many baklava because snape must sprinkle the souffles
since a student may arrange a eclaire that sirius can gobble draco must not assemble the strudels which the professor may assemble	since a student may arrange a eclaire that sirius can gobble draco must not assemble the strudels which the student may assemble
because lily should giggle a wizard can not prepare the chocolates since a wizard may gobble a chocolate which fred should assemble	because lily should hide a chocolate fred can not assemble the chocolates since a wizard should gobble a chocolate which fred may prepare
because dobby must gobble the doughnuts that fred may hide because a witch should gobble the cakes james must gobble the doughnut	because dobby must gobble the doughnuts that fred may hide because a witch should gobble the doughnut james must gobble the cakes
lupin should not assemble the cookies because snape must make a cookie that dobby must gobble because snape must hide the chocolate	lupin should not assemble the cookies because snape must make because a must gobble the cookie because vernon must hide the chocolate
since he should eat a cookie hermione can not eat the baklava since mcgonagall must chew the strudels that albus should gobble	since he should eat a cookie neville can not eat the baklava that mcgonagall should chew the strudels which albus must gobble
since a witch must hide the souffle which lily may sprinkle petunia can make the chocolates because lily must assemble a eclaire	since a witch must hide the souffle which lily may sprinkle petunia can make the eclaires because lily must assemble the chocolates
because snape should arrange the pancake george can not assemble the cakes because james can create the cake that harry can sprinkle	because snape should arrange the pancake george can not assemble the cakes because james can create the cake that sirius can sprinkle
neville must not eat the cakes that ginny can create since a professor must eat the chocolates which a student should chew	neville must not eat the cakes that ginny can eat since a professor must create the chocolates which a student should chew
since petunia must chew many chocolates since she may gobble the baklava albus must not assemble the cakes that sirius can create	since petunia must gobble many chocolates since she may chew the baklava she must not assemble the cakes that sirius can create
because hagrid must sprinkle the baklava fred may not run because lily must gobble the doughnut because sirius may gobble the cakes	because hagrid must sprinkle the baklava because fred may create the cookies sirius must not gobble because snape may assemble the doughnut
since james can assemble the baklava neville can not make the souffle which she should sprinkle since harry should prepare the cake	since james can assemble the baklava neville can not make the strudel which mcgonagall should sprinkle since harry should prepare the pancakes
since a wizard must chew the pancake that a student may assemble harry must not hide many eclaires which sirius must create	since a wizard must chew the pancake that a student may assemble sirius must not hide many eclaires which harry must create
since ron can eat many cookies that hagrid should hide since he may sprinkle the cookie a professor should chew the baklava	since ron can eat many cookies that hagrid should hide since he may sprinkle the cookie hagrid should chew the baklava
since a wizard can smile because petunia can assemble the pancake because lupin should chew the baklava ron may eat the croissant	since a wizard can smile because lupin can assemble the baklava because petunia should chew the strudel ron may eat the baklava
since hagrid can chew a cake that lupin should prepare because ginny should eat many pancakes albus may not hide a eclaire	since hagrid can chew a souffle that lupin should prepare because ginny should eat many eclaires albus may not hide a chocolates
because mcgonagall can walk since vernon may eat many eclaires a professor can not arrange the baklava that a witch can gobble	because mcgonagall can walk since vernon may eat many strudels a professor can not arrange the cookies that a witch can gobble
because hermione must eat the cookie because james can create the doughnut lupin may not create the baklava which james should eat	because hermione must eat the cookie because james can create the baklava lupin may not create the doughnut which james should eat
since ron must wiggle because draco should prepare the doughnuts snape can not prepare a souffle since snape must make the chocolates	since ron must wiggle because draco should prepare the doughnuts snape can not prepare a souffle because snape must make the chocolates
since ron must chew a eclaire she can not hide the cakes that a wizard should eat since a professor may laugh	since ron must chew the cakes she can not hide a eclaire that a wizard should eat since voldemort may laugh
because ginny must eat a pancake that harry can create hermione must not chew the chocolate since lily must hide the cookie	because ginny must eat a chocolate that snape can chew harry must not create the cookie since ginny must hide the chocolate
the witch must not hide the croissants that the wizard may make since albus should gobble the croissant that he should prepare	the witch must not hide the croissants that the wizard may gobble since he should make the croissant that albus should prepare
fred may not giggle since lupin must arrange a eclaire because dobby may eat the strudels because voldemort should sprinkle a pancake	fred may not giggle because lupin may laugh since the wizard must sprinkle a eclaire because dobby should arrange many strudels
since sirius must chew the souffle since dobby must assemble the eclaires ginny can not create the cake that dobby must chew	since sirius must chew the souffle since dobby must assemble the eclaires dobby can not create the cake that dobby must chew
since a professor may gobble the souffle that sirius may eat the wizard may not hiccup since ron may make the croissant	since a professor may gobble the croissant that sirius may eat the wizard may not make the souffle since ron may hide the cakes
since harry may arrange the cakes which hagrid must assemble because george can make many eclaires mcgonagall may not make a strudel	since harry may arrange the cakes which hagrid must assemble george can not make many eclaires because mcgonagall may make
harry may not eat the cookies which petunia must make since james should make the cakes because harry should eat the cookies	harry may not eat the cookies which petunia must make since harry should make the cakes since james should eat the cookies
since a professor must run since he may create the eclaire a student may not chew the doughnuts because he should hiccup	since a professor must run he may not create the eclaire since a student should chew the he may hiccup he may walk
because a student should make the chocolates that snape should assemble a wizard can not sprinkle a chocolate that fred may gobble	because a student should make the chocolates that snape should assemble fred can not sprinkle a chocolate that a wizard may gobble
snape should not gobble the strudels that a professor may hide since the student may sprinkle the chocolates that hermione must make	snape should not gobble the strudels that a student may hide since the professor may sprinkle the chocolates that hermione must make
the wizard must eat a eclaire that a professor can prepare since the wizard may chew the pancake that george can make	the wizard must eat a eclaire that a professor can prepare since george may the the pancake that the wizard can chew
since he should create the eclaires george may not create the cake which hagrid may create since fred must chew the croissant	since he should create the eclaires which george may create hagrid may not create the eclaire since george must chew the strudels
because george can sprinkle a chocolate that vernon may gobble fred must not gobble the souffles since dobby can make the doughnut	because george can sprinkle a souffle that vernon may gobble fred must not sprinkle the pancake since dobby can make the strudels
because james can hide many chocolates lupin should not walk since a professor must sprinkle a souffle which a professor should eat	because james can hide many chocolates since lupin should walk a professor should not sprinkle a souffle which a professor must eat
since the professor must run because hermione may create the cakes that sirius may assemble a wizard can not assemble a baklava	since the professor must run because hermione may create the cakes that a witch can assemble sirius may not assemble a croissant
since the student may assemble the doughnuts which the wizard should chew since she can hide a chocolate a wizard must hiccup	since the student should assemble the doughnuts which the wizard may chew she can hide a chocolate since a wizard must hiccup
because the student can eat the strudel since lupin must chew a croissant which mcgonagall may hide lupin should create a souffle	because the student can eat the strudel since lupin must chew a croissant mcgonagall may hide a cookie which lupin should chew
fred must not create the souffle because fred can assemble many pancakes that ginny must chew since sirius may create the doughnut	fred must not create the souffle that fred can assemble because sirius must chew many pancakes since petunia may create the doughnut
since the wizard must eat a baklava lupin may not hide the cookies since voldemort should hide the croissant that he may create	since the wizard must eat the baklava a may not hide the croissant since lupin should hide the baklava that he may create
since vernon must hide a pancake which he can hide a student should prepare the cakes because a wizard must eat a cake	since vernon must hide a pancake which he can hide a student should make many cakes which the wizard must eat a cake
harry may not arrange the cakes since neville may arrange the cake that fred must arrange because the student must make the doughnut	harry may not arrange the cakes since neville may arrange the eclaires that the student must make because neville must arrange the cake
because the wizard can gobble the eclaire which a professor can gobble snape can not hide the baklava which the wizard should gobble	because the wizard can gobble the eclaire which a can can eat lily should not gobble the cookies which the wizard can gobble
hagrid must not hide the doughnuts since fred should assemble the souffles which james must hide since a witch can gobble a souffle	hagrid must not hide the doughnuts which fred should assemble since james must hide the souffles since a witch can gobble a souffle
a student should not hide a cookie that the professor must eat since petunia should make the cake which the student may make	a student should not hide a cookie that the professor must eat since petunia should make the cake that the student may make
because albus must chew a eclaire that albus can eat snape may assemble the eclaire that she must chew because harry can walk	because albus must assemble a eclaire that snape may hide albus can chew the eclaires because she must smile
because a witch must sprinkle the souffles which albus may make she may not assemble a cookie since ron can chew the cake	because a witch must sprinkle the souffles which albus may make she may not assemble a strudel since ron can chew the chocolates
because the student can arrange a cookie that a student can chew he can not sprinkle a croissant that a professor must chew	because the student can arrange a cookie that a student can chew he can not sprinkle a croissant that a student must chew
a witch can not hide the strudels since she may chew the pancakes because draco must chew a cake that she may gobble	a witch can not hide the pancakes because she may chew the strudels since sirius may chew a cake that she must gobble
draco must not arrange a cookie that dobby can make since the student must assemble the strudels since petunia must create the cakes	draco must not arrange a cookie that dobby can make since the student must assemble the eclaires since petunia must create the cakes
since the professor should make the eclaire since snape can make the croissants which harry must eat ron must not chew the doughnuts	since the professor should make the eclaire since snape can eat the croissants harry must not make the doughnuts since ron must chew the eclaires
since snape may swim because lupin must chew the strudels that he may gobble neville can assemble the chocolates that she may eat	since snape may swim because he must chew the strudels that she may assemble he can gobble the chocolates that neville may eat
since the professor may chew a eclaire sirius can not prepare the pancakes that draco must eat since dobby can make the strudels	since the professor may chew a eclaire sirius can not prepare the pancakes that sirius must make since dobby can prepare the strudels
lupin must not chew the souffles since he must hide the souffle that a student must eat since lily can gobble many souffles	lupin must not chew the souffles since he must hide the cookie that a student can eat since snape must gobble the souffles
she must not assemble the doughnut since albus should create the chocolates that ron must assemble because a witch must hide the cake	she must not assemble the doughnut that albus should create since the witch must hide the cake because albus must assemble the cake
because albus can eat the croissant the wizard can not make the baklava since albus can eat the eclaires that sirius must prepare	because albus can eat the croissant the wizard can not make the baklava since sirius can eat the eclaires that albus must prepare
because harry must create a doughnut he should not arrange the eclaire since albus must sprinkle the souffle that the witch must hide	because harry must create a doughnut he should not arrange the eclaire since albus must sprinkle the souffles that the witch must hide
since a student should hide the strudels fred may not eat the strudels which george must make because harry must create a baklava	since a student should hide the strudels which george may eat fred should not create the strudels because neville must make a baklava
since lupin should create the cookie draco may not prepare the baklava because a witch must gobble the cakes which she may make	since lupin should create the cookie draco may not prepare the baklava because a witch may gobble the cakes which she must make
because a wizard may arrange the baklava that lily can prepare james must not chew a doughnut because hagrid may create the strudel	because a wizard may arrange the baklava that harry can prepare lily may not chew a souffle because james must create the strudel
because she can make the strudel because the wizard can create a cookie vernon can not wiggle since vernon can create many doughnuts	because she can make the strudel vernon the wizard can create a cookie vernon can not wiggle because vernon can gobble the doughnuts
since petunia may arrange a strudel that the student may eat a wizard should not hide the souffle because lupin may make the cakes	since petunia may hide a strudel that a wizard may arrange the student should not eat the cookie because lupin may chew the cakes
sirius must not eat a cake since fred may chew the croissant since vernon should eat a baklava because harry can arrange the cakes	sirius must not eat a cake since vernon may chew the baklava since sirius should eat the strudels since a student can arrange the
since lily may walk harry must not eat the cookie which hermione can hide since george may hide the eclaire that hagrid should create	since lily may walk neville must not hide the cookie that hermione may prepare since albus can hide the eclaire which george should hide
because he must prepare a doughnut that a wizard can chew the wizard should not wiggle since a wizard can gobble the strudels	because he must prepare a doughnut that a wizard can chew a wizard should not wiggle since the wizard can gobble the strudels
the professor should not create the souffles that a witch must arrange because draco may eat the pancake which a wizard may create	the professor should not create the souffles that a witch may eat because draco must arrange the pancake which a wizard may create
since he can chew the cookies a wizard should not arrange a eclaire since a professor should arrange a eclaire that ron may create	since he can chew the cookies a wizard should not arrange a eclaire since ron should arrange a eclaire that a professor may create
since the wizard must hide the baklava that hagrid must chew she may not arrange a eclaire since the wizard must chew the souffles	since the wizard must hide the baklava that hagrid may chew she must not chew the a since hagrid must arrange the strudels that she must chew
a wizard must not chew the strudels that the witch must make because a student may sprinkle the cake which the student can eat	a wizard must not chew the strudels that the student must make because a witch may sprinkle the cake which the student can eat
snape must not make the doughnut that she can eat since harry may smile since he may arrange the cookie which she should sprinkle	snape must not make the doughnut that she may eat since neville can smile since she should arrange the cookie which she may make
because fred can chew the souffles which he must chew snape can not laugh since hagrid should prepare the cakes that he must create	because fred can chew the souffles which he must hide snape can not chew the cakes since he must create the cakes that snape should hide
